sample_id,strain1,strain2,chrom,start,end,length
SMI000-K02-B01-M02,0,1,Pf3D7_02_v3,405079,434163,29084
SMI000-K02-B01-M02,0,1,Pf3D7_02_v3,468251,828325,360074
SMI000-K02-B01-M02,0,1,Pf3D7_03_v3,361403,926595,565192
SMI000-K02-B01-M02,0,1,Pf3D7_04_v3,255939,999012,743073
SMI000-K02-B01-M02,0,1,Pf3D7_04_v3,1037822,1143965,106143
SMI000-K02-B01-M02,0,1,Pf3D7_05_v3,39872,92221,52349
SMI000-K02-B01-M02,0,1,Pf3D7_05_v3,351970,482621,130651
SMI000-K02-B01-M02,0,1,Pf3D7_05_v3,1038517,1166914,128397
SMI000-K02-B01-M02,0,1,Pf3D7_05_v3,1204155,1217961,13806
SMI000-K02-B01-M02,0,1,Pf3D7_06_v3,796597,1079212,282615
SMI000-K02-B01-M02,0,1,Pf3D7_06_v3,1111651,1294070,182419
SMI000-K02-B01-M02,0,1,Pf3D7_07_v3,77194,132909,55715
SMI000-K02-B01-M02,0,1,Pf3D7_07_v3,1354996,1380526,25530
SMI000-K02-B01-M02,0,1,Pf3D7_08_v3,75691,1045210,969519
SMI000-K02-B01-M02,0,1,Pf3D7_08_v3,1113495,1364499,251004
SMI000-K02-B01-M02,0,1,Pf3D7_09_v3,82153,685626,603473
SMI000-K02-B01-M02,0,1,Pf3D7_09_v3,1206669,1326676,120007
SMI000-K02-B01-M02,0,1,Pf3D7_10_v3,1295838,1570149,274311
SMI000-K02-B01-M02,0,1,Pf3D7_11_v3,110641,769251,658610
SMI000-K02-B01-M02,0,1,Pf3D7_11_v3,778298,1195964,417666
SMI000-K02-B01-M02,0,1,Pf3D7_11_v3,1209400,1294584,85184
SMI000-K02-B01-M02,0,1,Pf3D7_11_v3,1464120,2003008,538888
SMI000-K02-B01-M02,0,1,Pf3D7_12_v3,61435,382400,320965
SMI000-K02-B01-M02,0,1,Pf3D7_12_v3,802744,2155095,1352351
SMI000-K02-B01-M02,0,1,Pf3D7_13_v3,77901,93019,15118
SMI000-K02-B01-M02,0,1,Pf3D7_13_v3,150114,2575636,2425522
SMI000-K02-B01-M02,0,1,Pf3D7_14_v3,415819,824306,408487
SMI000-K02-B01-M02,0,1,Pf3D7_14_v3,2451029,3255607,804578
SMI001-K02-B01-M03,0,1,Pf3D7_01_v3,95518,530521,435003
SMI001-K02-B01-M03,0,1,Pf3D7_02_v3,278302,805840,527538
SMI001-K02-B01-M03,0,1,Pf3D7_03_v3,637453,878750,241297
SMI001-K02-B01-M03,0,1,Pf3D7_03_v3,891306,1002946,111640
SMI001-K02-B01-M03,0,1,Pf3D7_04_v3,91817,833197,741380
SMI001-K02-B01-M03,0,1,Pf3D7_04_v3,883380,1143965,260585
SMI001-K02-B01-M03,0,1,Pf3D7_05_v3,39872,329606,289734
SMI001-K02-B01-M03,0,1,Pf3D7_05_v3,1004479,1321074,316595
SMI001-K02-B01-M03,0,1,Pf3D7_06_v3,74373,114595,40222
SMI001-K02-B01-M03,0,1,Pf3D7_06_v3,229484,1282691,1053207
SMI001-K02-B01-M03,0,1,Pf3D7_07_v3,80194,105304,25110
SMI001-K02-B01-M03,0,1,Pf3D7_07_v3,221631,619957,398326
SMI001-K02-B01-M03,0,1,Pf3D7_08_v3,362183,422166,59983
SMI001-K02-B01-M03,0,1,Pf3D7_08_v3,509018,672242,163224
SMI001-K02-B01-M03,0,1,Pf3D7_08_v3,674002,845861,171859
SMI001-K02-B01-M03,0,1,Pf3D7_08_v3,1225428,1341249,115821
SMI001-K02-B01-M03,0,1,Pf3D7_09_v3,416031,811232,395201
SMI001-K02-B01-M03,0,1,Pf3D7_10_v3,399698,1570149,1170451
SMI001-K02-B01-M03,0,1,Pf3D7_11_v3,110641,2003008,1892367
SMI001-K02-B01-M03,0,1,Pf3D7_12_v3,61435,122749,61314
SMI001-K02-B01-M03,0,1,Pf3D7_12_v3,379979,2155095,1775116
SMI001-K02-B01-M03,0,1,Pf3D7_13_v3,77901,2788579,2710678
SMI001-K02-B01-M03,0,1,Pf3D7_14_v3,35796,45271,9475
SMI001-K02-B01-M03,0,1,Pf3D7_14_v3,407424,475506,68082
SMI001-K02-B01-M03,0,1,Pf3D7_14_v3,1034851,2970085,1935234
SMI001-K02-B01-M03,0,1,Pf3D7_14_v3,3238019,3255607,17588
SMI002-K02-B01-M02,0,1,Pf3D7_01_v3,95518,532656,437138
SMI002-K02-B01-M02,0,1,Pf3D7_02_v3,582922,614624,31702
SMI002-K02-B01-M02,0,1,Pf3D7_02_v3,617482,862030,244548
SMI002-K02-B01-M02,0,1,Pf3D7_03_v3,71040,360119,289079
SMI002-K02-B01-M02,0,1,Pf3D7_03_v3,501455,654721,153266
SMI002-K02-B01-M02,0,1,Pf3D7_03_v3,752418,850847,98429
SMI002-K02-B01-M02,0,1,Pf3D7_03_v3,878750,1002946,124196
SMI002-K02-B01-M02,0,1,Pf3D7_04_v3,91817,115195,23378
SMI002-K02-B01-M02,0,1,Pf3D7_04_v3,255939,470382,214443
SMI002-K02-B01-M02,0,1,Pf3D7_04_v3,679043,888892,209849
SMI002-K02-B01-M02,0,1,Pf3D7_04_v3,903207,999012,95805
SMI002-K02-B01-M02,0,1,Pf3D7_04_v3,1006336,1143965,137629
SMI002-K02-B01-M02,0,1,Pf3D7_05_v3,39872,616768,576896
SMI002-K02-B01-M02,0,1,Pf3D7_05_v3,1038517,1321074,282557
SMI002-K02-B01-M02,0,1,Pf3D7_06_v3,74373,1111651,1037278
SMI002-K02-B01-M02,0,1,Pf3D7_07_v3,77194,609762,532568
SMI002-K02-B01-M02,0,1,Pf3D7_07_v3,627478,628263,785
SMI002-K02-B01-M02,0,1,Pf3D7_07_v3,635254,718071,82817
SMI002-K02-B01-M02,0,1,Pf3D7_07_v3,1171997,1354996,182999
SMI002-K02-B01-M02,0,1,Pf3D7_08_v3,826695,1289177,462482
SMI002-K02-B01-M02,0,1,Pf3D7_08_v3,1317740,1363211,45471
SMI002-K02-B01-M02,0,1,Pf3D7_09_v3,773035,1472334,699299
SMI002-K02-B01-M02,0,1,Pf3D7_10_v3,70764,1570149,1499385
SMI002-K02-B01-M02,0,1,Pf3D7_11_v3,110641,281726,171085
SMI002-K02-B01-M02,0,1,Pf3D7_11_v3,386092,1173924,787832
SMI002-K02-B01-M02,0,1,Pf3D7_11_v3,1595699,1935051,339352
SMI002-K02-B01-M02,0,1,Pf3D7_12_v3,377095,2155095,1778000
SMI002-K02-B01-M02,0,1,Pf3D7_13_v3,77901,106161,28260
SMI002-K02-B01-M02,0,1,Pf3D7_13_v3,1255528,1359289,103761
SMI002-K02-B01-M02,0,1,Pf3D7_13_v3,1466327,2107756,641429
SMI002-K02-B01-M02,0,1,Pf3D7_13_v3,2575636,2788579,212943
SMI002-K02-B01-M02,0,1,Pf3D7_14_v3,35796,475506,439710
SMI002-K02-B01-M02,0,1,Pf3D7_14_v3,481785,918720,436935
SMI002-K02-B01-M02,0,1,Pf3D7_14_v3,2020660,2451029,430369
SMI002-K02-B01-M02,0,1,Pf3D7_14_v3,2467008,3255607,788599
SMI005-K02-B01-M03,0,1,Pf3D7_02_v3,468251,693767,225516
SMI005-K02-B01-M03,0,1,Pf3D7_03_v3,140327,1002946,862619
SMI005-K02-B01-M03,0,1,Pf3D7_04_v3,91817,255939,164122
SMI005-K02-B01-M03,0,1,Pf3D7_04_v3,860538,910225,49687
SMI005-K02-B01-M03,0,1,Pf3D7_04_v3,999012,1143965,144953
SMI005-K02-B01-M03,0,1,Pf3D7_05_v3,39872,92082,52210
SMI005-K02-B01-M03,0,1,Pf3D7_05_v3,95628,147419,51791
SMI005-K02-B01-M03,0,1,Pf3D7_05_v3,150624,383150,232526
SMI005-K02-B01-M03,0,1,Pf3D7_05_v3,897486,1321074,423588
SMI005-K02-B01-M03,0,1,Pf3D7_06_v3,74373,285246,210873
SMI005-K02-B01-M03,0,1,Pf3D7_06_v3,304643,1294070,989427
SMI005-K02-B01-M03,0,1,Pf3D7_07_v3,77194,333500,256306
SMI005-K02-B01-M03,0,1,Pf3D7_07_v3,415137,432784,17647
SMI005-K02-B01-M03,0,1,Pf3D7_07_v3,452331,619957,167626
SMI005-K02-B01-M03,0,1,Pf3D7_07_v3,1171997,1380526,208529
SMI005-K02-B01-M03,0,1,Pf3D7_08_v3,75691,1275087,1199396
SMI005-K02-B01-M03,0,1,Pf3D7_08_v3,1289102,1297594,8492
SMI005-K02-B01-M03,0,1,Pf3D7_08_v3,1310687,1364499,53812
SMI005-K02-B01-M03,0,1,Pf3D7_09_v3,82153,764812,682659
SMI005-K02-B01-M03,0,1,Pf3D7_09_v3,853207,1419023,565816
SMI005-K02-B01-M03,0,1,Pf3D7_10_v3,557657,1565523,1007866
SMI005-K02-B01-M03,0,1,Pf3D7_11_v3,778298,2003008,1224710
SMI005-K02-B01-M03,0,1,Pf3D7_12_v3,61435,382400,320965
SMI005-K02-B01-M03,0,1,Pf3D7_12_v3,399327,458280,58953
SMI005-K02-B01-M03,0,1,Pf3D7_12_v3,806785,1670700,863915
SMI005-K02-B01-M03,0,1,Pf3D7_13_v3,77901,860281,782380
SMI005-K02-B01-M03,0,1,Pf3D7_13_v3,1890723,1891015,292
SMI005-K02-B01-M03,0,1,Pf3D7_13_v3,2063107,2788579,725472
SMI005-K02-B01-M03,0,1,Pf3D7_14_v3,35796,407424,371628
SMI005-K02-B01-M03,0,1,Pf3D7_14_v3,918720,3043747,2125027
SMI005-K02-B01-M03,0,1,Pf3D7_14_v3,3044236,3255607,211371
SMI006-K02-B01-M02,0,1,Pf3D7_01_v3,95518,180068,84550
SMI006-K02-B01-M02,0,1,Pf3D7_02_v3,179137,468251,289114
SMI006-K02-B01-M02,0,1,Pf3D7_02_v3,614624,692837,78213
SMI006-K02-B01-M02,0,1,Pf3D7_02_v3,805840,862030,56190
SMI006-K02-B01-M02,0,1,Pf3D7_03_v3,71040,221547,150507
SMI006-K02-B01-M02,0,1,Pf3D7_03_v3,878750,1002946,124196
SMI006-K02-B01-M02,0,1,Pf3D7_04_v3,91817,255939,164122
SMI006-K02-B01-M02,0,1,Pf3D7_04_v3,283484,414221,130737
SMI006-K02-B01-M02,0,1,Pf3D7_04_v3,630376,1101687,471311
SMI006-K02-B01-M02,0,1,Pf3D7_04_v3,1136615,1143965,7350
SMI006-K02-B01-M02,0,1,Pf3D7_05_v3,39872,1321074,1281202
SMI006-K02-B01-M02,0,1,Pf3D7_06_v3,74373,346856,272483
SMI006-K02-B01-M02,0,1,Pf3D7_06_v3,796597,1111651,315054
SMI006-K02-B01-M02,0,1,Pf3D7_07_v3,157969,158694,725
SMI006-K02-B01-M02,0,1,Pf3D7_07_v3,361356,1158082,796726
SMI006-K02-B01-M02,0,1,Pf3D7_07_v3,1218770,1380526,161756
SMI006-K02-B01-M02,0,1,Pf3D7_08_v3,75691,1312190,1236499
SMI006-K02-B01-M02,0,1,Pf3D7_09_v3,416031,1472334,1056303
SMI006-K02-B01-M02,0,1,Pf3D7_10_v3,70764,75884,5120
SMI006-K02-B01-M02,0,1,Pf3D7_10_v3,333340,335297,1957
SMI006-K02-B01-M02,0,1,Pf3D7_10_v3,808864,1254230,445366
SMI006-K02-B01-M02,0,1,Pf3D7_11_v3,355143,360271,5128
SMI006-K02-B01-M02,0,1,Pf3D7_11_v3,1993165,2003008,9843
SMI006-K02-B01-M02,0,1,Pf3D7_12_v3,61435,532133,470698
SMI006-K02-B01-M02,0,1,Pf3D7_12_v3,1670700,2155095,484395
SMI006-K02-B01-M02,0,1,Pf3D7_13_v3,77901,106161,28260
SMI006-K02-B01-M02,0,1,Pf3D7_13_v3,1891015,2410243,519228
SMI006-K02-B01-M02,0,1,Pf3D7_13_v3,2575636,2741236,165600
SMI006-K02-B01-M02,0,1,Pf3D7_14_v3,337415,918720,581305
SMI006-K02-B01-M02,0,1,Pf3D7_14_v3,1037043,1367225,330182
SMI006-K02-B01-M02,0,1,Pf3D7_14_v3,2020660,2061817,41157
SMI009-K02-B01-M02,0,1,Pf3D7_01_v3,95518,567657,472139
SMI009-K02-B01-M02,0,1,Pf3D7_02_v3,109248,805840,696592
SMI009-K02-B01-M02,0,1,Pf3D7_04_v3,679043,883380,204337
SMI009-K02-B01-M02,0,1,Pf3D7_04_v3,1095788,1143965,48177
SMI009-K02-B01-M02,0,1,Pf3D7_05_v3,39872,43677,3805
SMI009-K02-B01-M02,0,1,Pf3D7_05_v3,550392,564986,14594
SMI009-K02-B01-M02,0,1,Pf3D7_05_v3,937121,1038517,101396
SMI009-K02-B01-M02,0,1,Pf3D7_05_v3,1204155,1321074,116919
SMI009-K02-B01-M02,0,1,Pf3D7_06_v3,74373,796597,722224
SMI009-K02-B01-M02,0,1,Pf3D7_06_v3,1111651,1290024,178373
SMI009-K02-B01-M02,0,1,Pf3D7_06_v3,1290456,1294070,3614
SMI009-K02-B01-M02,0,1,Pf3D7_07_v3,77194,456262,379068
SMI009-K02-B01-M02,0,1,Pf3D7_07_v3,615869,1196326,580457
SMI009-K02-B01-M02,0,1,Pf3D7_07_v3,1202320,1380466,178146
SMI009-K02-B01-M02,0,1,Pf3D7_08_v3,529764,1152268,622504
SMI009-K02-B01-M02,0,1,Pf3D7_09_v3,283356,482799,199443
SMI009-K02-B01-M02,0,1,Pf3D7_10_v3,1285388,1570149,284761
SMI009-K02-B01-M02,0,1,Pf3D7_11_v3,110641,2003008,1892367
SMI009-K02-B01-M02,0,1,Pf3D7_12_v3,61435,682902,621467
SMI009-K02-B01-M02,0,1,Pf3D7_12_v3,1362616,2155095,792479
SMI009-K02-B01-M02,0,1,Pf3D7_13_v3,77901,155834,77933
SMI009-K02-B01-M02,0,1,Pf3D7_13_v3,816992,976005,159013
SMI009-K02-B01-M02,0,1,Pf3D7_13_v3,1310690,2788579,1477889
SMI009-K02-B01-M02,0,1,Pf3D7_14_v3,35796,106972,71176
SMI009-K02-B01-M02,0,1,Pf3D7_14_v3,512987,2733656,2220669
SMI009-K02-B01-M02,0,1,Pf3D7_14_v3,3098922,3255607,156685
SMI010-K02-B01-M01,0,1,Pf3D7_01_v3,339504,567657,228153
SMI010-K02-B01-M01,0,1,Pf3D7_02_v3,109248,862030,752782
SMI010-K02-B01-M01,0,1,Pf3D7_03_v3,71040,805130,734090
SMI010-K02-B01-M01,0,1,Pf3D7_04_v3,255939,891051,635112
SMI010-K02-B01-M01,0,1,Pf3D7_04_v3,999012,1042880,43868
SMI010-K02-B01-M01,0,1,Pf3D7_05_v3,131301,236079,104778
SMI010-K02-B01-M01,0,1,Pf3D7_05_v3,1288644,1321074,32430
SMI010-K02-B01-M01,0,1,Pf3D7_06_v3,74373,345483,271110
SMI010-K02-B01-M01,0,1,Pf3D7_06_v3,496187,824690,328503
SMI010-K02-B01-M01,0,1,Pf3D7_06_v3,1111651,1290456,178805
SMI010-K02-B01-M01,0,1,Pf3D7_07_v3,227275,499425,272150
SMI010-K02-B01-M01,0,1,Pf3D7_07_v3,619957,883904,263947
SMI010-K02-B01-M01,0,1,Pf3D7_07_v3,1119385,1170354,50969
SMI010-K02-B01-M01,0,1,Pf3D7_08_v3,398723,810631,411908
SMI010-K02-B01-M01,0,1,Pf3D7_08_v3,1201455,1278610,77155
SMI010-K02-B01-M01,0,1,Pf3D7_09_v3,706328,868611,162283
SMI010-K02-B01-M01,0,1,Pf3D7_09_v3,1014530,1472334,457804
SMI010-K02-B01-M01,0,1,Pf3D7_10_v3,70764,113505,42741
SMI010-K02-B01-M01,0,1,Pf3D7_10_v3,341106,538449,197343
SMI010-K02-B01-M01,0,1,Pf3D7_10_v3,561234,1254230,692996
SMI010-K02-B01-M01,0,1,Pf3D7_11_v3,918588,2003008,1084420
SMI010-K02-B01-M01,0,1,Pf3D7_12_v3,61435,382400,320965
SMI010-K02-B01-M01,0,1,Pf3D7_12_v3,845137,913124,67987
SMI010-K02-B01-M01,0,1,Pf3D7_13_v3,1404123,2575636,1171513
SMI010-K02-B01-M01,0,1,Pf3D7_14_v3,39964,590793,550829
SMI010-K02-B01-M01,0,1,Pf3D7_14_v3,918720,1307328,388608
SMI010-K02-B01-M01,0,1,Pf3D7_14_v3,2406952,2451690,44738
SMI010-K02-B01-M01,0,1,Pf3D7_14_v3,3084224,3255607,171383
SMI011-K02-B01-M03,0,1,Pf3D7_01_v3,95518,567657,472139
SMI011-K02-B01-M03,0,1,Pf3D7_02_v3,109248,805840,696592
SMI011-K02-B01-M03,0,1,Pf3D7_02_v3,834663,862030,27367
SMI011-K02-B01-M03,0,1,Pf3D7_03_v3,71040,1002946,931906
SMI011-K02-B01-M03,0,1,Pf3D7_04_v3,91817,695742,603925
SMI011-K02-B01-M03,0,1,Pf3D7_04_v3,766775,1143965,377190
SMI011-K02-B01-M03,0,1,Pf3D7_05_v3,39872,383150,343278
SMI011-K02-B01-M03,0,1,Pf3D7_05_v3,921360,1321074,399714
SMI011-K02-B01-M03,0,1,Pf3D7_06_v3,74373,1111651,1037278
SMI011-K02-B01-M03,0,1,Pf3D7_07_v3,480458,1109226,628768
SMI011-K02-B01-M03,0,1,Pf3D7_07_v3,1159773,1380526,220753
SMI011-K02-B01-M03,0,1,Pf3D7_08_v3,75691,1278610,1202919
SMI011-K02-B01-M03,0,1,Pf3D7_09_v3,89887,1472334,1382447
SMI011-K02-B01-M03,0,1,Pf3D7_10_v3,70764,185257,114493
SMI011-K02-B01-M03,0,1,Pf3D7_10_v3,222264,1570149,1347885
SMI011-K02-B01-M03,0,1,Pf3D7_11_v3,110641,753550,642909
SMI011-K02-B01-M03,0,1,Pf3D7_11_v3,1132096,2003008,870912
SMI011-K02-B01-M03,0,1,Pf3D7_12_v3,61435,382400,320965
SMI011-K02-B01-M03,0,1,Pf3D7_12_v3,1212825,1238648,25823
SMI011-K02-B01-M03,0,1,Pf3D7_13_v3,106161,795086,688925
SMI011-K02-B01-M03,0,1,Pf3D7_13_v3,1481332,1512247,30915
SMI011-K02-B01-M03,0,1,Pf3D7_13_v3,1528349,1891015,362666
SMI011-K02-B01-M03,0,1,Pf3D7_13_v3,2309043,2575636,266593
SMI011-K02-B01-M03,0,1,Pf3D7_14_v3,501766,631239,129473
SMI011-K02-B01-M03,0,1,Pf3D7_14_v3,918720,2451029,1532309
SMI011-K02-B01-M03,0,1,Pf3D7_14_v3,2614985,2615069,84
SMI011-K02-B01-M03,0,1,Pf3D7_14_v3,3027048,3197006,169958
SMI013-K02-B01-M03,0,1,Pf3D7_01_v3,95518,137258,41740
SMI013-K02-B01-M03,0,1,Pf3D7_01_v3,180172,516289,336117
SMI013-K02-B01-M03,0,1,Pf3D7_01_v3,528425,555388,26963
SMI013-K02-B01-M03,0,1,Pf3D7_02_v3,468251,843180,374929
SMI013-K02-B01-M03,0,1,Pf3D7_02_v3,855754,862030,6276
SMI013-K02-B01-M03,0,1,Pf3D7_03_v3,71040,1002946,931906
SMI013-K02-B01-M03,0,1,Pf3D7_04_v3,91817,144427,52610
SMI013-K02-B01-M03,0,1,Pf3D7_04_v3,255939,1032565,776626
SMI013-K02-B01-M03,0,1,Pf3D7_04_v3,1101687,1130666,28979
SMI013-K02-B01-M03,0,1,Pf3D7_05_v3,154819,1321074,1166255
SMI013-K02-B01-M03,0,1,Pf3D7_06_v3,74373,1294070,1219697
SMI013-K02-B01-M03,0,1,Pf3D7_07_v3,77194,105304,28110
SMI013-K02-B01-M03,0,1,Pf3D7_07_v3,376423,1285356,908933
SMI013-K02-B01-M03,0,1,Pf3D7_08_v3,169455,247238,77783
SMI013-K02-B01-M03,0,1,Pf3D7_08_v3,477060,486709,9649
SMI013-K02-B01-M03,0,1,Pf3D7_08_v3,509018,1079292,570274
SMI013-K02-B01-M03,0,1,Pf3D7_08_v3,1113495,1364499,251004
SMI013-K02-B01-M03,0,1,Pf3D7_09_v3,82153,1472334,1390181
SMI013-K02-B01-M03,0,1,Pf3D7_10_v3,70764,199483,128719
SMI013-K02-B01-M03,0,1,Pf3D7_10_v3,1318156,1570149,251993
SMI013-K02-B01-M03,0,1,Pf3D7_11_v3,110641,2003008,1892367
SMI013-K02-B01-M03,0,1,Pf3D7_12_v3,61435,2155095,2093660
SMI013-K02-B01-M03,0,1,Pf3D7_13_v3,77901,256854,178953
SMI013-K02-B01-M03,0,1,Pf3D7_13_v3,762355,769044,6689
SMI013-K02-B01-M03,0,1,Pf3D7_13_v3,792970,2788579,1995609
SMI013-K02-B01-M03,0,1,Pf3D7_14_v3,35796,2954801,2919005
SMI013-K02-B01-M03,0,1,Pf3D7_14_v3,3121296,3124670,3374
SMI014-K02-B01-M03,0,1,Pf3D7_01_v3,95518,567657,472139
SMI014-K02-B01-M03,0,1,Pf3D7_02_v3,109248,278302,169054
SMI014-K02-B01-M03,0,1,Pf3D7_02_v3,297229,862030,564801
SMI014-K02-B01-M03,0,1,Pf3D7_03_v3,71040,590480,519440
SMI014-K02-B01-M03,0,1,Pf3D7_03_v3,689276,1002946,313670
SMI014-K02-B01-M03,0,1,Pf3D7_04_v3,91817,156536,64719
SMI014-K02-B01-M03,0,1,Pf3D7_04_v3,255939,748262,492323
SMI014-K02-B01-M03,0,1,Pf3D7_04_v3,805221,999012,193791
SMI014-K02-B01-M03,0,1,Pf3D7_05_v3,69564,127859,58295
SMI014-K02-B01-M03,0,1,Pf3D7_05_v3,216203,1038517,822314
SMI014-K02-B01-M03,0,1,Pf3D7_05_v3,1114074,1204155,90081
SMI014-K02-B01-M03,0,1,Pf3D7_05_v3,1237394,1321074,83680
SMI014-K02-B01-M03,0,1,Pf3D7_06_v3,74373,1294070,1219697
SMI014-K02-B01-M03,0,1,Pf3D7_07_v3,77194,622939,545745
SMI014-K02-B01-M03,0,1,Pf3D7_07_v3,1229133,1380526,151393
SMI014-K02-B01-M03,0,1,Pf3D7_08_v3,75691,1364499,1288808
SMI014-K02-B01-M03,0,1,Pf3D7_09_v3,82153,416031,333878
SMI014-K02-B01-M03,0,1,Pf3D7_09_v3,586735,1472334,885599
SMI014-K02-B01-M03,0,1,Pf3D7_10_v3,70764,1570149,1499385
SMI014-K02-B01-M03,0,1,Pf3D7_11_v3,110641,2003008,1892367
SMI014-K02-B01-M03,0,1,Pf3D7_12_v3,61435,382400,320965
SMI014-K02-B01-M03,0,1,Pf3D7_12_v3,1054417,2155095,1100678
SMI014-K02-B01-M03,0,1,Pf3D7_13_v3,77901,2788579,2710678
SMI014-K02-B01-M03,0,1,Pf3D7_14_v3,35796,371725,335929
SMI014-K02-B01-M03,0,1,Pf3D7_14_v3,699548,918720,219172
SMI014-K02-B01-M03,0,1,Pf3D7_14_v3,1854863,1993465,138602
SMI014-K02-B01-M03,0,1,Pf3D7_14_v3,2451029,3255607,804578
SMI016-K02-B01-M02,0,1,Pf3D7_01_v3,95518,567657,472139
SMI016-K02-B01-M02,0,1,Pf3D7_02_v3,109248,862030,752782
SMI016-K02-B01-M02,0,1,Pf3D7_03_v3,71040,1002946,931906
SMI016-K02-B01-M02,0,1,Pf3D7_04_v3,91817,1143965,1052148
SMI016-K02-B01-M02,0,1,Pf3D7_05_v3,39872,118209,78337
SMI016-K02-B01-M02,0,1,Pf3D7_05_v3,216203,358424,142221
SMI016-K02-B01-M02,0,1,Pf3D7_05_v3,669320,1321074,651754
SMI016-K02-B01-M02,0,1,Pf3D7_06_v3,74373,796597,722224
SMI016-K02-B01-M02,0,1,Pf3D7_06_v3,799889,1294070,494181
SMI016-K02-B01-M02,0,1,Pf3D7_07_v3,77194,85131,7937
SMI016-K02-B01-M02,0,1,Pf3D7_07_v3,460942,496692,35750
SMI016-K02-B01-M02,0,1,Pf3D7_07_v3,619957,1380526,760569
SMI016-K02-B01-M02,0,1,Pf3D7_08_v3,75691,1364499,1288808
SMI016-K02-B01-M02,0,1,Pf3D7_09_v3,82153,1141801,1059648
SMI016-K02-B01-M02,0,1,Pf3D7_09_v3,1360864,1468714,107850
SMI016-K02-B01-M02,0,1,Pf3D7_10_v3,700215,1570149,869934
SMI016-K02-B01-M02,0,1,Pf3D7_11_v3,110641,1429069,1318428
SMI016-K02-B01-M02,0,1,Pf3D7_11_v3,1935051,2003008,67957
SMI016-K02-B01-M02,0,1,Pf3D7_12_v3,61435,1548670,1487235
SMI016-K02-B01-M02,0,1,Pf3D7_12_v3,1670700,2155095,484395
SMI016-K02-B01-M02,0,1,Pf3D7_13_v3,77901,560291,482390
SMI016-K02-B01-M02,0,1,Pf3D7_13_v3,585306,2788579,2203273
SMI016-K02-B01-M02,0,1,Pf3D7_14_v3,35796,475506,439710
SMI016-K02-B01-M02,0,1,Pf3D7_14_v3,918720,1202249,283529
SMI016-K02-B01-M02,0,1,Pf3D7_14_v3,2451029,3255607,804578
SMI017-K02-B01-M02,0,1,Pf3D7_01_v3,178474,179952,1478
SMI017-K02-B01-M02,0,1,Pf3D7_01_v3,190739,528425,337686
SMI017-K02-B01-M02,0,1,Pf3D7_02_v3,166372,862030,695658
SMI017-K02-B01-M02,0,1,Pf3D7_03_v3,71040,920967,849927
SMI017-K02-B01-M02,0,1,Pf3D7_04_v3,188719,428163,239444
SMI017-K02-B01-M02,0,1,Pf3D7_04_v3,541844,630298,88454
SMI017-K02-B01-M02,0,1,Pf3D7_04_v3,897099,901096,3997
SMI017-K02-B01-M02,0,1,Pf3D7_04_v3,992024,1100624,108600
SMI017-K02-B01-M02,0,1,Pf3D7_05_v3,92082,1038517,946435
SMI017-K02-B01-M02,0,1,Pf3D7_05_v3,1204155,1321074,116919
SMI017-K02-B01-M02,0,1,Pf3D7_06_v3,74373,1282691,1208318
SMI017-K02-B01-M02,0,1,Pf3D7_07_v3,463930,1380526,916596
SMI017-K02-B01-M02,0,1,Pf3D7_08_v3,75691,509018,433327
SMI017-K02-B01-M02,0,1,Pf3D7_08_v3,943578,1364499,420921
SMI017-K02-B01-M02,0,1,Pf3D7_09_v3,82153,595955,513802
SMI017-K02-B01-M02,0,1,Pf3D7_09_v3,686984,1472334,785350
SMI017-K02-B01-M02,0,1,Pf3D7_10_v3,70764,1254230,1183466
SMI017-K02-B01-M02,0,1,Pf3D7_10_v3,1387402,1570149,182747
SMI017-K02-B01-M02,0,1,Pf3D7_11_v3,110641,163420,52779
SMI017-K02-B01-M02,0,1,Pf3D7_11_v3,265114,2003008,1737894
SMI017-K02-B01-M02,0,1,Pf3D7_12_v3,61435,382400,320965
SMI017-K02-B01-M02,0,1,Pf3D7_12_v3,1116767,2155095,1038328
SMI017-K02-B01-M02,0,1,Pf3D7_13_v3,77901,1891015,1813114
SMI017-K02-B01-M02,0,1,Pf3D7_13_v3,2575636,2788579,212943
SMI017-K02-B01-M02,0,1,Pf3D7_14_v3,35796,2257195,2221399
SMI017-K02-B01-M02,0,1,Pf3D7_14_v3,2451029,3124731,673702
SMI017-K02-B01-M02,0,1,Pf3D7_14_v3,3193462,3255607,62145
SMI019-K02-B01-M03,0,1,Pf3D7_01_v3,95518,567657,472139
SMI019-K02-B01-M03,0,1,Pf3D7_02_v3,109248,862030,752782
SMI019-K02-B01-M03,0,1,Pf3D7_03_v3,71040,1002946,931906
SMI019-K02-B01-M03,0,1,Pf3D7_04_v3,91817,1143965,1052148
SMI019-K02-B01-M03,0,1,Pf3D7_05_v3,39872,1321074,1281202
SMI019-K02-B01-M03,0,1,Pf3D7_06_v3,74373,1283256,1208883
SMI019-K02-B01-M03,0,1,Pf3D7_07_v3,481542,1380526,898984
SMI019-K02-B01-M03,0,1,Pf3D7_08_v3,75691,1292327,1216636
SMI019-K02-B01-M03,0,1,Pf3D7_08_v3,1325910,1364499,38589
SMI019-K02-B01-M03,0,1,Pf3D7_09_v3,82153,416031,333878
SMI019-K02-B01-M03,0,1,Pf3D7_09_v3,723918,811232,87314
SMI019-K02-B01-M03,0,1,Pf3D7_09_v3,837879,1472334,634455
SMI019-K02-B01-M03,0,1,Pf3D7_10_v3,70764,454626,383862
SMI019-K02-B01-M03,0,1,Pf3D7_10_v3,922261,1570149,647888
SMI019-K02-B01-M03,0,1,Pf3D7_11_v3,110641,2003008,1892367
SMI019-K02-B01-M03,0,1,Pf3D7_12_v3,61435,2155095,2093660
SMI019-K02-B01-M03,0,1,Pf3D7_13_v3,77901,1419239,1341338
SMI019-K02-B01-M03,0,1,Pf3D7_13_v3,1466327,2788579,1322252
SMI019-K02-B01-M03,0,1,Pf3D7_14_v3,35796,699548,663752
SMI019-K02-B01-M03,0,1,Pf3D7_14_v3,918720,2267725,1349005
SMI019-K02-B01-M03,0,1,Pf3D7_14_v3,2757993,3255607,497614
SMI021-K02-B01-M01,0,1,Pf3D7_01_v3,95518,145515,49997
SMI021-K02-B01-M01,0,1,Pf3D7_01_v3,528425,530463,2038
SMI021-K02-B01-M01,0,1,Pf3D7_04_v3,255939,628776,372837
SMI021-K02-B01-M01,0,1,Pf3D7_04_v3,999012,1035493,36481
SMI021-K02-B01-M01,0,1,Pf3D7_05_v3,269653,350957,81304
SMI021-K02-B01-M01,0,1,Pf3D7_05_v3,1219742,1321074,101332
SMI021-K02-B01-M01,0,1,Pf3D7_06_v3,74373,1111651,1037278
SMI021-K02-B01-M01,0,1,Pf3D7_10_v3,189952,489227,299275
SMI021-K02-B01-M01,0,1,Pf3D7_11_v3,777831,1294584,516753
SMI021-K02-B01-M01,0,1,Pf3D7_11_v3,2001759,2003008,1249
SMI021-K02-B01-M01,0,1,Pf3D7_12_v3,61435,382400,320965
SMI021-K02-B01-M01,0,1,Pf3D7_12_v3,550805,857245,306440
SMI021-K02-B01-M01,0,1,Pf3D7_13_v3,865434,2788579,1923145
SMI021-K02-B01-M01,0,1,Pf3D7_14_v3,35796,675777,639981
SMI021-K02-B01-M01,0,1,Pf3D7_14_v3,2615069,3255607,640538
SMI023-K02-B01-M03,0,1,Pf3D7_01_v3,95518,567657,472139
SMI023-K02-B01-M03,0,1,Pf3D7_02_v3,109248,468251,359003
SMI023-K02-B01-M03,0,1,Pf3D7_02_v3,805840,862030,56190
SMI023-K02-B01-M03,0,1,Pf3D7_03_v3,71040,452795,381755
SMI023-K02-B01-M03,0,1,Pf3D7_03_v3,510722,1002946,492224
SMI023-K02-B01-M03,0,1,Pf3D7_04_v3,91817,516523,424706
SMI023-K02-B01-M03,0,1,Pf3D7_04_v3,528936,545154,16218
SMI023-K02-B01-M03,0,1,Pf3D7_04_v3,655877,797570,141693
SMI023-K02-B01-M03,0,1,Pf3D7_04_v3,860538,1143965,283427
SMI023-K02-B01-M03,0,1,Pf3D7_05_v3,39872,1204155,1164283
SMI023-K02-B01-M03,0,1,Pf3D7_06_v3,81126,1282691,1201565
SMI023-K02-B01-M03,0,1,Pf3D7_07_v3,433609,480458,46849
SMI023-K02-B01-M03,0,1,Pf3D7_07_v3,619957,1380526,760569
SMI023-K02-B01-M03,0,1,Pf3D7_08_v3,75691,119204,43513
SMI023-K02-B01-M03,0,1,Pf3D7_08_v3,133128,509018,375890
SMI023-K02-B01-M03,0,1,Pf3D7_08_v3,1113495,1187420,73925
SMI023-K02-B01-M03,0,1,Pf3D7_08_v3,1311927,1364499,52572
SMI023-K02-B01-M03,0,1,Pf3D7_09_v3,82153,811232,729079
SMI023-K02-B01-M03,0,1,Pf3D7_09_v3,1014530,1472334,457804
SMI023-K02-B01-M03,0,1,Pf3D7_10_v3,70764,1254230,1183466
SMI023-K02-B01-M03,0,1,Pf3D7_11_v3,119609,385357,265748
SMI023-K02-B01-M03,0,1,Pf3D7_11_v3,410610,913589,502979
SMI023-K02-B01-M03,0,1,Pf3D7_11_v3,1084422,2003008,918586
SMI023-K02-B01-M03,0,1,Pf3D7_12_v3,61435,122749,61314
SMI023-K02-B01-M03,0,1,Pf3D7_12_v3,382400,1390850,1008450
SMI023-K02-B01-M03,0,1,Pf3D7_12_v3,1660673,1670700,10027
SMI023-K02-B01-M03,0,1,Pf3D7_13_v3,106161,206448,100287
SMI023-K02-B01-M03,0,1,Pf3D7_13_v3,1229674,1232346,2672
SMI023-K02-B01-M03,0,1,Pf3D7_13_v3,2575636,2788579,212943
SMI023-K02-B01-M03,0,1,Pf3D7_14_v3,35796,202238,166442
SMI023-K02-B01-M03,0,1,Pf3D7_14_v3,407424,429723,22299
SMI023-K02-B01-M03,0,1,Pf3D7_14_v3,1863852,3121601,1257749
SMI027-K02-B01-M02,0,1,Pf3D7_01_v3,95518,567657,472139
SMI027-K02-B01-M02,0,1,Pf3D7_02_v3,109248,278302,169054
SMI027-K02-B01-M02,0,1,Pf3D7_02_v3,784379,862030,77651
SMI027-K02-B01-M02,0,1,Pf3D7_03_v3,71040,504002,432962
SMI027-K02-B01-M02,0,1,Pf3D7_03_v3,827914,878750,50836
SMI027-K02-B01-M02,0,1,Pf3D7_04_v3,545154,630569,85415
SMI027-K02-B01-M02,0,1,Pf3D7_04_v3,763069,832042,68973
SMI027-K02-B01-M02,0,1,Pf3D7_04_v3,882698,994765,112067
SMI027-K02-B01-M02,0,1,Pf3D7_04_v3,999012,1101651,102639
SMI027-K02-B01-M02,0,1,Pf3D7_05_v3,39912,383150,343238
SMI027-K02-B01-M02,0,1,Pf3D7_05_v3,672685,1038517,365832
SMI027-K02-B01-M02,0,1,Pf3D7_06_v3,1111651,1115191,3540
SMI027-K02-B01-M02,0,1,Pf3D7_06_v3,1268187,1290456,22269
SMI027-K02-B01-M02,0,1,Pf3D7_07_v3,132909,619957,487048
SMI027-K02-B01-M02,0,1,Pf3D7_07_v3,1318017,1380526,62509
SMI027-K02-B01-M02,0,1,Pf3D7_08_v3,75691,1313202,1237511
SMI027-K02-B01-M02,0,1,Pf3D7_08_v3,1345148,1363211,18063
SMI027-K02-B01-M02,0,1,Pf3D7_09_v3,416031,500646,84615
SMI027-K02-B01-M02,0,1,Pf3D7_09_v3,862838,1206669,343831
SMI027-K02-B01-M02,0,1,Pf3D7_10_v3,1074462,1570149,495687
SMI027-K02-B01-M02,0,1,Pf3D7_11_v3,110641,647711,537070
SMI027-K02-B01-M02,0,1,Pf3D7_12_v3,61435,122749,61314
SMI027-K02-B01-M02,0,1,Pf3D7_12_v3,459459,1670700,1211241
SMI027-K02-B01-M02,0,1,Pf3D7_13_v3,81044,106161,25117
SMI027-K02-B01-M02,0,1,Pf3D7_13_v3,194874,315401,120527
SMI027-K02-B01-M02,0,1,Pf3D7_13_v3,378458,541473,163015
SMI027-K02-B01-M02,0,1,Pf3D7_13_v3,1891015,2575636,684621
SMI027-K02-B01-M02,0,1,Pf3D7_13_v3,2755017,2788579,33562
SMI027-K02-B01-M02,0,1,Pf3D7_14_v3,35796,855174,819378
SMI027-K02-B01-M02,0,1,Pf3D7_14_v3,921395,1035373,113978
SMI027-K02-B01-M02,0,1,Pf3D7_14_v3,1992095,2451029,458934
SMI027-K02-B01-M02,0,1,Pf3D7_14_v3,2467008,3255607,788599
SMI028-K02-B01-M03,0,1,Pf3D7_01_v3,180309,567657,387348
SMI028-K02-B01-M03,0,1,Pf3D7_02_v3,109248,297229,187981
SMI028-K02-B01-M03,0,1,Pf3D7_02_v3,309386,862030,552644
SMI028-K02-B01-M03,0,1,Pf3D7_03_v3,71040,1002946,931906
SMI028-K02-B01-M03,0,1,Pf3D7_04_v3,91817,1143965,1052148
SMI028-K02-B01-M03,0,1,Pf3D7_05_v3,39872,1114074,1074202
SMI028-K02-B01-M03,0,1,Pf3D7_05_v3,1204155,1321074,116919
SMI028-K02-B01-M03,0,1,Pf3D7_06_v3,74373,1294070,1219697
SMI028-K02-B01-M03,0,1,Pf3D7_07_v3,77194,1262543,1185349
SMI028-K02-B01-M03,0,1,Pf3D7_08_v3,509018,1113495,604477
SMI028-K02-B01-M03,0,1,Pf3D7_08_v3,1278610,1364499,85889
SMI028-K02-B01-M03,0,1,Pf3D7_09_v3,82153,1472334,1390181
SMI028-K02-B01-M03,0,1,Pf3D7_10_v3,70764,1570149,1499385
SMI028-K02-B01-M03,0,1,Pf3D7_11_v3,110641,2003008,1892367
SMI028-K02-B01-M03,0,1,Pf3D7_12_v3,61435,122749,61314
SMI028-K02-B01-M03,0,1,Pf3D7_12_v3,320260,817686,497426
SMI028-K02-B01-M03,0,1,Pf3D7_12_v3,1212825,2155095,942270
SMI028-K02-B01-M03,0,1,Pf3D7_13_v3,77901,106161,28260
SMI028-K02-B01-M03,0,1,Pf3D7_13_v3,106601,1619394,1512793
SMI028-K02-B01-M03,0,1,Pf3D7_13_v3,1891015,2788579,897564
SMI028-K02-B01-M03,0,1,Pf3D7_14_v3,35796,3255607,3219811
SMI029-K02-B01-M03,0,1,Pf3D7_01_v3,238688,567657,328969
SMI029-K02-B01-M03,0,1,Pf3D7_02_v3,109248,805840,696592
SMI029-K02-B01-M03,0,1,Pf3D7_03_v3,143964,751699,607735
SMI029-K02-B01-M03,0,1,Pf3D7_04_v3,255939,988618,732679
SMI029-K02-B01-M03,0,1,Pf3D7_04_v3,999012,1143965,144953
SMI029-K02-B01-M03,0,1,Pf3D7_05_v3,39872,383150,343278
SMI029-K02-B01-M03,0,1,Pf3D7_05_v3,481328,1038517,557189
SMI029-K02-B01-M03,0,1,Pf3D7_05_v3,1114074,1184487,70413
SMI029-K02-B01-M03,0,1,Pf3D7_05_v3,1185671,1321074,135403
SMI029-K02-B01-M03,0,1,Pf3D7_06_v3,74373,229484,155111
SMI029-K02-B01-M03,0,1,Pf3D7_06_v3,796597,1294070,497473
SMI029-K02-B01-M03,0,1,Pf3D7_07_v3,77194,1380526,1303332
SMI029-K02-B01-M03,0,1,Pf3D7_08_v3,75691,104543,28852
SMI029-K02-B01-M03,0,1,Pf3D7_08_v3,152948,1364499,1211551
SMI029-K02-B01-M03,0,1,Pf3D7_09_v3,82153,1427845,1345692
SMI029-K02-B01-M03,0,1,Pf3D7_10_v3,185257,1570149,1384892
SMI029-K02-B01-M03,0,1,Pf3D7_11_v3,110641,484009,373368
SMI029-K02-B01-M03,0,1,Pf3D7_11_v3,1294584,1887740,593156
SMI029-K02-B01-M03,0,1,Pf3D7_12_v3,122749,1670700,1547951
SMI029-K02-B01-M03,0,1,Pf3D7_13_v3,1983852,2323925,340073
SMI029-K02-B01-M03,0,1,Pf3D7_13_v3,2575636,2788579,212943
SMI029-K02-B01-M03,0,1,Pf3D7_14_v3,35796,699548,663752
SMI029-K02-B01-M03,0,1,Pf3D7_14_v3,918720,3121601,2202881
SMI030-K02-B01-M01,0,1,Pf3D7_02_v3,311372,805840,494468
SMI030-K02-B01-M01,0,1,Pf3D7_03_v3,79845,660596,580751
SMI030-K02-B01-M01,0,1,Pf3D7_04_v3,255939,544673,288734
SMI030-K02-B01-M01,0,1,Pf3D7_04_v3,1094136,1143965,49829
SMI030-K02-B01-M01,0,1,Pf3D7_05_v3,39872,279024,239152
SMI030-K02-B01-M01,0,1,Pf3D7_06_v3,114520,542351,427831
SMI030-K02-B01-M01,0,1,Pf3D7_06_v3,815124,1294070,478946
SMI030-K02-B01-M01,0,1,Pf3D7_07_v3,77194,1158082,1080888
SMI030-K02-B01-M01,0,1,Pf3D7_08_v3,467879,619138,151259
SMI030-K02-B01-M01,0,1,Pf3D7_10_v3,1254230,1432783,178553
SMI030-K02-B01-M01,0,1,Pf3D7_11_v3,1294584,2003008,708424
SMI030-K02-B01-M01,0,1,Pf3D7_12_v3,61435,727996,666561
SMI030-K02-B01-M01,0,1,Pf3D7_12_v3,1670700,2155095,484395
SMI030-K02-B01-M01,0,1,Pf3D7_13_v3,77901,1879453,1801552
SMI030-K02-B01-M01,0,1,Pf3D7_14_v3,442110,918720,476610
SMI030-K02-B01-M01,0,1,Pf3D7_14_v3,2858476,3255607,397131
SMI031-K02-B01-M02,0,1,Pf3D7_01_v3,164024,487895,323871
SMI031-K02-B01-M02,0,1,Pf3D7_02_v3,371009,862030,491021
SMI031-K02-B01-M02,0,1,Pf3D7_03_v3,71040,1002946,931906
SMI031-K02-B01-M02,0,1,Pf3D7_04_v3,91817,630130,538313
SMI031-K02-B01-M02,0,1,Pf3D7_04_v3,695081,1143965,448884
SMI031-K02-B01-M02,0,1,Pf3D7_05_v3,39872,1042080,1002208
SMI031-K02-B01-M02,0,1,Pf3D7_05_v3,1304829,1321074,16245
SMI031-K02-B01-M02,0,1,Pf3D7_06_v3,74373,1294070,1219697
SMI031-K02-B01-M02,0,1,Pf3D7_07_v3,77194,332719,255525
SMI031-K02-B01-M02,0,1,Pf3D7_07_v3,424310,445215,20905
SMI031-K02-B01-M02,0,1,Pf3D7_07_v3,619957,1380526,760569
SMI031-K02-B01-M02,0,1,Pf3D7_08_v3,75691,426829,351138
SMI031-K02-B01-M02,0,1,Pf3D7_08_v3,666328,834628,168300
SMI031-K02-B01-M02,0,1,Pf3D7_08_v3,861388,1109232,247844
SMI031-K02-B01-M02,0,1,Pf3D7_08_v3,1278610,1360603,81993
SMI031-K02-B01-M02,0,1,Pf3D7_09_v3,157331,158728,1397
SMI031-K02-B01-M02,0,1,Pf3D7_10_v3,195405,1254230,1058825
SMI031-K02-B01-M02,0,1,Pf3D7_10_v3,1387489,1570149,182660
SMI031-K02-B01-M02,0,1,Pf3D7_11_v3,110641,987161,876520
SMI031-K02-B01-M02,0,1,Pf3D7_11_v3,1748856,2003008,254152
SMI031-K02-B01-M02,0,1,Pf3D7_12_v3,61435,824940,763505
SMI031-K02-B01-M02,0,1,Pf3D7_12_v3,1670700,2142883,472183
SMI031-K02-B01-M02,0,1,Pf3D7_13_v3,1891015,2020792,129777
SMI031-K02-B01-M02,0,1,Pf3D7_13_v3,2575636,2788579,212943
SMI031-K02-B01-M02,0,1,Pf3D7_14_v3,35796,675798,640002
SMI031-K02-B01-M02,0,1,Pf3D7_14_v3,1034851,3205133,2170282
SMI034-K02-B01-M03,0,1,Pf3D7_01_v3,95518,567657,472139
SMI034-K02-B01-M03,0,1,Pf3D7_02_v3,109248,862030,752782
SMI034-K02-B01-M03,0,1,Pf3D7_03_v3,71040,1002946,931906
SMI034-K02-B01-M03,0,1,Pf3D7_04_v3,91817,414221,322404
SMI034-K02-B01-M03,0,1,Pf3D7_04_v3,615475,999012,383537
SMI034-K02-B01-M03,0,1,Pf3D7_04_v3,1138574,1143965,5391
SMI034-K02-B01-M03,0,1,Pf3D7_05_v3,39872,1178624,1138752
SMI034-K02-B01-M03,0,1,Pf3D7_05_v3,1204155,1321074,116919
SMI034-K02-B01-M03,0,1,Pf3D7_06_v3,74373,1294070,1219697
SMI034-K02-B01-M03,0,1,Pf3D7_07_v3,77194,1091670,1014476
SMI034-K02-B01-M03,0,1,Pf3D7_07_v3,1256654,1380526,123872
SMI034-K02-B01-M03,0,1,Pf3D7_08_v3,75691,169455,93764
SMI034-K02-B01-M03,0,1,Pf3D7_08_v3,331833,1001916,670083
SMI034-K02-B01-M03,0,1,Pf3D7_08_v3,1103480,1364499,261019
SMI034-K02-B01-M03,0,1,Pf3D7_09_v3,82153,1472334,1390181
SMI034-K02-B01-M03,0,1,Pf3D7_10_v3,70764,1570149,1499385
SMI034-K02-B01-M03,0,1,Pf3D7_11_v3,110641,1637389,1526748
SMI034-K02-B01-M03,0,1,Pf3D7_11_v3,1749819,2003008,253189
SMI034-K02-B01-M03,0,1,Pf3D7_12_v3,61435,2155095,2093660
SMI034-K02-B01-M03,0,1,Pf3D7_13_v3,77901,106161,28260
SMI034-K02-B01-M03,0,1,Pf3D7_13_v3,155588,2341466,2185878
SMI034-K02-B01-M03,0,1,Pf3D7_13_v3,2545438,2788579,243141
SMI034-K02-B01-M03,0,1,Pf3D7_14_v3,35796,3255607,3219811
SMI036-K02-B01-M01,0,1,Pf3D7_01_v3,207736,339504,131768
SMI036-K02-B01-M01,0,1,Pf3D7_03_v3,501455,1002946,501491
SMI036-K02-B01-M01,0,1,Pf3D7_04_v3,91817,837210,745393
SMI036-K02-B01-M01,0,1,Pf3D7_05_v3,150291,615484,465193
SMI036-K02-B01-M01,0,1,Pf3D7_05_v3,1038517,1043303,4786
SMI036-K02-B01-M01,0,1,Pf3D7_06_v3,408976,542351,133375
SMI036-K02-B01-M01,0,1,Pf3D7_06_v3,869449,1111651,242202
SMI036-K02-B01-M01,0,1,Pf3D7_06_v3,1274832,1289167,14335
SMI036-K02-B01-M01,0,1,Pf3D7_07_v3,881909,1380526,498617
SMI036-K02-B01-M01,0,1,Pf3D7_08_v3,75691,369734,294043
SMI036-K02-B01-M01,0,1,Pf3D7_08_v3,425913,426883,970
SMI036-K02-B01-M01,0,1,Pf3D7_08_v3,490297,526923,36626
SMI036-K02-B01-M01,0,1,Pf3D7_08_v3,529764,895234,365470
SMI036-K02-B01-M01,0,1,Pf3D7_08_v3,1113813,1290961,177148
SMI036-K02-B01-M01,0,1,Pf3D7_09_v3,1131898,1472334,340436
SMI036-K02-B01-M01,0,1,Pf3D7_10_v3,70764,222766,152002
SMI036-K02-B01-M01,0,1,Pf3D7_10_v3,561234,728132,166898
SMI036-K02-B01-M01,0,1,Pf3D7_10_v3,1074462,1510637,436175
SMI036-K02-B01-M01,0,1,Pf3D7_11_v3,1294584,1375053,80469
SMI036-K02-B01-M01,0,1,Pf3D7_12_v3,1670700,2155095,484395
SMI036-K02-B01-M01,0,1,Pf3D7_13_v3,77901,1341364,1263463
SMI036-K02-B01-M01,0,1,Pf3D7_14_v3,602104,918720,316616
SMI037-K02-B01-M01,0,1,Pf3D7_01_v3,95906,178474,82568
SMI037-K02-B01-M01,0,1,Pf3D7_01_v3,182927,516289,333362
SMI037-K02-B01-M01,0,1,Pf3D7_02_v3,311729,855754,544025
SMI037-K02-B01-M01,0,1,Pf3D7_03_v3,140678,357947,217269
SMI037-K02-B01-M01,0,1,Pf3D7_03_v3,751533,1002946,251413
SMI037-K02-B01-M01,0,1,Pf3D7_04_v3,91817,255939,164122
SMI037-K02-B01-M01,0,1,Pf3D7_04_v3,766795,836739,69944
SMI037-K02-B01-M01,0,1,Pf3D7_04_v3,999012,1143965,144953
SMI037-K02-B01-M01,0,1,Pf3D7_05_v3,39872,43677,3805
SMI037-K02-B01-M01,0,1,Pf3D7_05_v3,144161,213086,68925
SMI037-K02-B01-M01,0,1,Pf3D7_05_v3,335672,450949,115277
SMI037-K02-B01-M01,0,1,Pf3D7_06_v3,833542,1269174,435632
SMI037-K02-B01-M01,0,1,Pf3D7_07_v3,176031,468540,292509
SMI037-K02-B01-M01,0,1,Pf3D7_07_v3,619957,1056854,436897
SMI037-K02-B01-M01,0,1,Pf3D7_07_v3,1158082,1256990,98908
SMI037-K02-B01-M01,0,1,Pf3D7_08_v3,331833,407080,75247
SMI037-K02-B01-M01,0,1,Pf3D7_08_v3,1103279,1278610,175331
SMI037-K02-B01-M01,0,1,Pf3D7_09_v3,289877,1472334,1182457
SMI037-K02-B01-M01,0,1,Pf3D7_10_v3,70764,92671,21907
SMI037-K02-B01-M01,0,1,Pf3D7_10_v3,1254230,1570149,315919
SMI037-K02-B01-M01,0,1,Pf3D7_11_v3,110641,1294216,1183575
SMI037-K02-B01-M01,0,1,Pf3D7_11_v3,1594572,1978659,384087
SMI037-K02-B01-M01,0,1,Pf3D7_12_v3,434725,817686,382961
SMI037-K02-B01-M01,0,1,Pf3D7_13_v3,860281,2788579,1928298
SMI037-K02-B01-M01,0,1,Pf3D7_14_v3,35796,675798,640002
SMI038-K02-B01-M01,0,1,Pf3D7_01_v3,529055,567657,38602
SMI038-K02-B01-M01,0,1,Pf3D7_02_v3,109248,862030,752782
SMI038-K02-B01-M01,0,1,Pf3D7_03_v3,71040,360794,289754
SMI038-K02-B01-M01,0,1,Pf3D7_04_v3,255939,848303,592364
SMI038-K02-B01-M01,0,1,Pf3D7_04_v3,1051722,1143965,92243
SMI038-K02-B01-M01,0,1,Pf3D7_05_v3,39872,426361,386489
SMI038-K02-B01-M01,0,1,Pf3D7_05_v3,671370,1038517,367147
SMI038-K02-B01-M01,0,1,Pf3D7_06_v3,836560,869449,32889
SMI038-K02-B01-M01,0,1,Pf3D7_07_v3,468540,619957,151417
SMI038-K02-B01-M01,0,1,Pf3D7_08_v3,1278610,1364499,85889
SMI038-K02-B01-M01,0,1,Pf3D7_09_v3,82153,1472334,1390181
SMI038-K02-B01-M01,0,1,Pf3D7_10_v3,70764,471727,400963
SMI038-K02-B01-M01,0,1,Pf3D7_12_v3,382400,892467,510067
SMI038-K02-B01-M01,0,1,Pf3D7_13_v3,1557136,2575636,1018500
SMI038-K02-B01-M01,0,1,Pf3D7_14_v3,339650,381583,41933
SMI001-K03-B01-M02,0,1,Pf3D7_01_v3,95518,536003,440485
SMI001-K03-B01-M02,0,1,Pf3D7_02_v3,109977,805840,695863
SMI001-K03-B01-M02,0,1,Pf3D7_03_v3,142126,341291,199165
SMI001-K03-B01-M02,0,1,Pf3D7_03_v3,654499,883928,229429
SMI001-K03-B01-M02,0,1,Pf3D7_04_v3,255939,910225,654286
SMI001-K03-B01-M02,0,1,Pf3D7_05_v3,62196,383150,320954
SMI001-K03-B01-M02,0,1,Pf3D7_05_v3,450949,1309669,858720
SMI001-K03-B01-M02,0,1,Pf3D7_06_v3,304643,635935,331292
SMI001-K03-B01-M02,0,1,Pf3D7_06_v3,965996,1294070,328074
SMI001-K03-B01-M02,0,1,Pf3D7_07_v3,77194,78335,1141
SMI001-K03-B01-M02,0,1,Pf3D7_07_v3,415775,619957,204182
SMI001-K03-B01-M02,0,1,Pf3D7_07_v3,665492,1171997,506505
SMI001-K03-B01-M02,0,1,Pf3D7_08_v3,313083,739292,426209
SMI001-K03-B01-M02,0,1,Pf3D7_08_v3,1201455,1278610,77155
SMI001-K03-B01-M02,0,1,Pf3D7_09_v3,127687,416031,288344
SMI001-K03-B01-M02,0,1,Pf3D7_09_v3,494966,951801,456835
SMI001-K03-B01-M02,0,1,Pf3D7_10_v3,70764,1570149,1499385
SMI001-K03-B01-M02,0,1,Pf3D7_11_v3,110641,778298,667657
SMI001-K03-B01-M02,0,1,Pf3D7_12_v3,122749,176847,54098
SMI001-K03-B01-M02,0,1,Pf3D7_12_v3,382400,458280,75880
SMI001-K03-B01-M02,0,1,Pf3D7_12_v3,659823,1387200,727377
SMI001-K03-B01-M02,0,1,Pf3D7_13_v3,308872,444696,135824
SMI001-K03-B01-M02,0,1,Pf3D7_13_v3,2343424,2788579,445155
SMI001-K03-B01-M02,0,1,Pf3D7_14_v3,35796,722437,686641
SMI001-K03-B01-M02,0,1,Pf3D7_14_v3,1159255,1454960,295705
SMI001-K03-B01-M02,0,1,Pf3D7_14_v3,2061817,3255607,1193790
SMI001-K03-B01-M02,0,2,Pf3D7_01_v3,95518,567657,472139
SMI001-K03-B01-M02,0,2,Pf3D7_02_v3,109248,109905,657
SMI001-K03-B01-M02,0,2,Pf3D7_02_v3,109977,862030,752053
SMI001-K03-B01-M02,0,2,Pf3D7_03_v3,71040,79845,8805
SMI001-K03-B01-M02,0,2,Pf3D7_03_v3,142126,654499,512373
SMI001-K03-B01-M02,0,2,Pf3D7_03_v3,883928,1002946,119018
SMI001-K03-B01-M02,0,2,Pf3D7_04_v3,91817,306393,214576
SMI001-K03-B01-M02,0,2,Pf3D7_04_v3,544615,646191,101576
SMI001-K03-B01-M02,0,2,Pf3D7_04_v3,910225,999012,88787
SMI001-K03-B01-M02,0,2,Pf3D7_04_v3,1095788,1143965,48177
SMI001-K03-B01-M02,0,2,Pf3D7_05_v3,39872,450949,411077
SMI001-K03-B01-M02,0,2,Pf3D7_05_v3,1038517,1321074,282557
SMI001-K03-B01-M02,0,2,Pf3D7_06_v3,74373,635935,561562
SMI001-K03-B01-M02,0,2,Pf3D7_06_v3,1111651,1294070,182419
SMI001-K03-B01-M02,0,2,Pf3D7_07_v3,77194,480458,403264
SMI001-K03-B01-M02,0,2,Pf3D7_07_v3,619957,1158082,538125
SMI001-K03-B01-M02,0,2,Pf3D7_07_v3,1171997,1354996,182999
SMI001-K03-B01-M02,0,2,Pf3D7_08_v3,467879,739292,271413
SMI001-K03-B01-M02,0,2,Pf3D7_08_v3,1278610,1364499,85889
SMI001-K03-B01-M02,0,2,Pf3D7_09_v3,82153,494966,412813
SMI001-K03-B01-M02,0,2,Pf3D7_09_v3,951801,1020977,69176
SMI001-K03-B01-M02,0,2,Pf3D7_10_v3,637656,1570149,932493
SMI001-K03-B01-M02,0,2,Pf3D7_11_v3,110641,1394203,1283562
SMI001-K03-B01-M02,0,2,Pf3D7_12_v3,122749,176847,54098
SMI001-K03-B01-M02,0,2,Pf3D7_12_v3,382400,659823,277423
SMI001-K03-B01-M02,0,2,Pf3D7_12_v3,1212111,2155095,942984
SMI001-K03-B01-M02,0,2,Pf3D7_13_v3,77901,308872,230971
SMI001-K03-B01-M02,0,2,Pf3D7_13_v3,444696,585306,140610
SMI001-K03-B01-M02,0,2,Pf3D7_13_v3,1591086,2575636,984550
SMI001-K03-B01-M02,0,2,Pf3D7_14_v3,722437,918720,196283
SMI001-K03-B01-M02,0,2,Pf3D7_14_v3,1159255,1454960,295705
SMI001-K03-B01-M02,0,2,Pf3D7_14_v3,2061817,3255607,1193790
SMI001-K03-B01-M02,1,2,Pf3D7_01_v3,95518,536003,440485
SMI001-K03-B01-M02,1,2,Pf3D7_02_v3,109905,805840,695935
SMI001-K03-B01-M02,1,2,Pf3D7_03_v3,79845,341291,261446
SMI001-K03-B01-M02,1,2,Pf3D7_04_v3,255939,306393,50454
SMI001-K03-B01-M02,1,2,Pf3D7_04_v3,544615,646191,101576
SMI001-K03-B01-M02,1,2,Pf3D7_04_v3,999012,1095788,96776
SMI001-K03-B01-M02,1,2,Pf3D7_05_v3,62196,383150,320954
SMI001-K03-B01-M02,1,2,Pf3D7_05_v3,1038517,1309669,271152
SMI001-K03-B01-M02,1,2,Pf3D7_06_v3,304643,965996,661353
SMI001-K03-B01-M02,1,2,Pf3D7_06_v3,1111651,1294070,182419
SMI001-K03-B01-M02,1,2,Pf3D7_07_v3,77194,78335,1141
SMI001-K03-B01-M02,1,2,Pf3D7_07_v3,415775,480458,64683
SMI001-K03-B01-M02,1,2,Pf3D7_07_v3,665492,1158082,492590
SMI001-K03-B01-M02,1,2,Pf3D7_07_v3,1354996,1380526,25530
SMI001-K03-B01-M02,1,2,Pf3D7_08_v3,75691,313083,237392
SMI001-K03-B01-M02,1,2,Pf3D7_08_v3,467879,1201455,733576
SMI001-K03-B01-M02,1,2,Pf3D7_09_v3,127687,416031,288344
SMI001-K03-B01-M02,1,2,Pf3D7_09_v3,1020977,1472334,451357
SMI001-K03-B01-M02,1,2,Pf3D7_10_v3,637656,1570149,932493
SMI001-K03-B01-M02,1,2,Pf3D7_11_v3,110641,778298,667657
SMI001-K03-B01-M02,1,2,Pf3D7_11_v3,1394203,2003008,608805
SMI001-K03-B01-M02,1,2,Pf3D7_12_v3,61435,458280,396845
SMI001-K03-B01-M02,1,2,Pf3D7_12_v3,1212111,1387200,175089
SMI001-K03-B01-M02,1,2,Pf3D7_13_v3,585306,1591086,1005780
SMI001-K03-B01-M02,1,2,Pf3D7_13_v3,2343424,2575636,232212
SMI001-K03-B01-M02,1,2,Pf3D7_14_v3,918720,3255607,2336887
SMI003-K03-B02-M03,0,1,Pf3D7_01_v3,179952,567657,387705
SMI003-K03-B02-M03,0,1,Pf3D7_02_v3,109248,862030,752782
SMI003-K03-B02-M03,0,1,Pf3D7_03_v3,71040,108315,37275
SMI003-K03-B02-M03,0,1,Pf3D7_03_v3,471494,562561,91067
SMI003-K03-B02-M03,0,1,Pf3D7_03_v3,758506,1002946,244440
SMI003-K03-B02-M03,0,1,Pf3D7_04_v3,91817,221401,129584
SMI003-K03-B02-M03,0,1,Pf3D7_04_v3,255939,394202,138263
SMI003-K03-B02-M03,0,1,Pf3D7_04_v3,528936,1143965,615029
SMI003-K03-B02-M03,0,1,Pf3D7_05_v3,39872,806914,767042
SMI003-K03-B02-M03,0,1,Pf3D7_05_v3,1011000,1321074,310074
SMI003-K03-B02-M03,0,1,Pf3D7_06_v3,74373,1111651,1037278
SMI003-K03-B02-M03,0,1,Pf3D7_06_v3,1282691,1294070,11379
SMI003-K03-B02-M03,0,1,Pf3D7_07_v3,77194,900965,823771
SMI003-K03-B02-M03,0,1,Pf3D7_07_v3,1058754,1380526,321772
SMI003-K03-B02-M03,0,1,Pf3D7_08_v3,75691,121384,45693
SMI003-K03-B02-M03,0,1,Pf3D7_08_v3,542477,1120456,577979
SMI003-K03-B02-M03,0,1,Pf3D7_08_v3,1310665,1364499,53834
SMI003-K03-B02-M03,0,1,Pf3D7_09_v3,82153,1472334,1390181
SMI003-K03-B02-M03,0,1,Pf3D7_10_v3,70764,604605,533841
SMI003-K03-B02-M03,0,1,Pf3D7_10_v3,638636,1570149,931513
SMI003-K03-B02-M03,0,1,Pf3D7_11_v3,110641,1749819,1639178
SMI003-K03-B02-M03,0,1,Pf3D7_11_v3,1957292,2003008,45716
SMI003-K03-B02-M03,0,1,Pf3D7_12_v3,61435,2155095,2093660
SMI003-K03-B02-M03,0,1,Pf3D7_13_v3,77901,1175471,1097570
SMI003-K03-B02-M03,0,1,Pf3D7_13_v3,1306830,1891015,584185
SMI003-K03-B02-M03,0,1,Pf3D7_13_v3,2102904,2788579,685675
SMI003-K03-B02-M03,0,1,Pf3D7_14_v3,35796,3218482,3182686
SMI005-K03-B01-M03,0,1,Pf3D7_01_v3,95518,567657,472139
SMI005-K03-B01-M03,0,1,Pf3D7_02_v3,109248,297229,187981
SMI005-K03-B01-M03,0,1,Pf3D7_02_v3,320861,414955,94094
SMI005-K03-B01-M03,0,1,Pf3D7_02_v3,805840,862030,56190
SMI005-K03-B01-M03,0,1,Pf3D7_03_v3,71040,383262,312222
SMI005-K03-B01-M03,0,1,Pf3D7_03_v3,506799,1002946,496147
SMI005-K03-B01-M03,0,1,Pf3D7_04_v3,91817,255939,164122
SMI005-K03-B01-M03,0,1,Pf3D7_04_v3,630376,832259,201883
SMI005-K03-B01-M03,0,1,Pf3D7_04_v3,863561,1101849,238288
SMI005-K03-B01-M03,0,1,Pf3D7_05_v3,69564,329406,259842
SMI005-K03-B01-M03,0,1,Pf3D7_05_v3,364200,404998,40798
SMI005-K03-B01-M03,0,1,Pf3D7_05_v3,929348,951120,21772
SMI005-K03-B01-M03,0,1,Pf3D7_05_v3,1038517,1042080,3563
SMI005-K03-B01-M03,0,1,Pf3D7_05_v3,1114074,1321074,207000
SMI005-K03-B01-M03,0,1,Pf3D7_06_v3,74373,796597,722224
SMI005-K03-B01-M03,0,1,Pf3D7_06_v3,1182560,1294070,111510
SMI005-K03-B01-M03,0,1,Pf3D7_07_v3,77194,449901,372707
SMI005-K03-B01-M03,0,1,Pf3D7_07_v3,466431,472858,6427
SMI005-K03-B01-M03,0,1,Pf3D7_07_v3,480458,619957,139499
SMI005-K03-B01-M03,0,1,Pf3D7_07_v3,635759,1380526,744767
SMI005-K03-B01-M03,0,1,Pf3D7_08_v3,75691,426829,351138
SMI005-K03-B01-M03,0,1,Pf3D7_08_v3,509018,582204,73186
SMI005-K03-B01-M03,0,1,Pf3D7_08_v3,1099944,1364499,264555
SMI005-K03-B01-M03,0,1,Pf3D7_09_v3,82153,265317,183164
SMI005-K03-B01-M03,0,1,Pf3D7_09_v3,416031,687921,271890
SMI005-K03-B01-M03,0,1,Pf3D7_10_v3,425295,992820,567525
SMI005-K03-B01-M03,0,1,Pf3D7_10_v3,1384940,1399091,14151
SMI005-K03-B01-M03,0,1,Pf3D7_10_v3,1513542,1570149,56607
SMI005-K03-B01-M03,0,1,Pf3D7_11_v3,110641,2003008,1892367
SMI005-K03-B01-M03,0,1,Pf3D7_12_v3,61435,2155095,2093660
SMI005-K03-B01-M03,0,1,Pf3D7_13_v3,77901,390249,312348
SMI005-K03-B01-M03,0,1,Pf3D7_13_v3,415785,1891015,1475230
SMI005-K03-B01-M03,0,1,Pf3D7_13_v3,2575636,2788579,212943
SMI005-K03-B01-M03,0,1,Pf3D7_14_v3,35796,1111557,1075761
SMI005-K03-B01-M03,0,1,Pf3D7_14_v3,2006084,2451029,444945
SMI005-K03-B01-M03,0,1,Pf3D7_14_v3,2867962,3051189,183227
SMI005-K03-B01-M03,0,2,Pf3D7_01_v3,95518,567657,472139
SMI005-K03-B01-M03,0,2,Pf3D7_02_v3,109248,414955,305707
SMI005-K03-B01-M03,0,2,Pf3D7_02_v3,468251,862030,393779
SMI005-K03-B01-M03,0,2,Pf3D7_03_v3,71040,383262,312222
SMI005-K03-B01-M03,0,2,Pf3D7_03_v3,506799,878750,371951
SMI005-K03-B01-M03,0,2,Pf3D7_04_v3,630376,832259,201883
SMI005-K03-B01-M03,0,2,Pf3D7_04_v3,880848,1101849,221001
SMI005-K03-B01-M03,0,2,Pf3D7_05_v3,62996,329406,266410
SMI005-K03-B01-M03,0,2,Pf3D7_05_v3,364200,1042080,677880
SMI005-K03-B01-M03,0,2,Pf3D7_05_v3,1114074,1321074,207000
SMI005-K03-B01-M03,0,2,Pf3D7_06_v3,74373,796597,722224
SMI005-K03-B01-M03,0,2,Pf3D7_06_v3,824787,1294070,469283
SMI005-K03-B01-M03,0,2,Pf3D7_07_v3,77194,466431,389237
SMI005-K03-B01-M03,0,2,Pf3D7_07_v3,472858,619957,147099
SMI005-K03-B01-M03,0,2,Pf3D7_07_v3,635759,1380526,744767
SMI005-K03-B01-M03,0,2,Pf3D7_08_v3,75691,426829,351138
SMI005-K03-B01-M03,0,2,Pf3D7_08_v3,500772,501390,618
SMI005-K03-B01-M03,0,2,Pf3D7_08_v3,509018,582204,73186
SMI005-K03-B01-M03,0,2,Pf3D7_08_v3,1099944,1364499,264555
SMI005-K03-B01-M03,0,2,Pf3D7_09_v3,82153,265317,183164
SMI005-K03-B01-M03,0,2,Pf3D7_09_v3,416031,687921,271890
SMI005-K03-B01-M03,0,2,Pf3D7_10_v3,425295,992820,567525
SMI005-K03-B01-M03,0,2,Pf3D7_10_v3,1254230,1384940,130710
SMI005-K03-B01-M03,0,2,Pf3D7_10_v3,1399091,1570149,171058
SMI005-K03-B01-M03,0,2,Pf3D7_11_v3,110641,2003008,1892367
SMI005-K03-B01-M03,0,2,Pf3D7_12_v3,61435,2155095,2093660
SMI005-K03-B01-M03,0,2,Pf3D7_13_v3,77901,2788579,2710678
SMI005-K03-B01-M03,0,2,Pf3D7_14_v3,35796,1111557,1075761
SMI005-K03-B01-M03,0,2,Pf3D7_14_v3,2006084,2451029,444945
SMI005-K03-B01-M03,0,2,Pf3D7_14_v3,2867962,3051189,183227
SMI005-K03-B01-M03,1,2,Pf3D7_01_v3,95518,567657,472139
SMI005-K03-B01-M03,1,2,Pf3D7_02_v3,109248,297229,187981
SMI005-K03-B01-M03,1,2,Pf3D7_02_v3,320861,468251,147390
SMI005-K03-B01-M03,1,2,Pf3D7_02_v3,805840,862030,56190
SMI005-K03-B01-M03,1,2,Pf3D7_03_v3,71040,878750,807710
SMI005-K03-B01-M03,1,2,Pf3D7_04_v3,255939,863561,607622
SMI005-K03-B01-M03,1,2,Pf3D7_04_v3,880848,1143965,263117
SMI005-K03-B01-M03,1,2,Pf3D7_05_v3,39872,62996,23124
SMI005-K03-B01-M03,1,2,Pf3D7_05_v3,69564,404998,335434
SMI005-K03-B01-M03,1,2,Pf3D7_05_v3,929348,951120,21772
SMI005-K03-B01-M03,1,2,Pf3D7_05_v3,1038517,1321074,282557
SMI005-K03-B01-M03,1,2,Pf3D7_06_v3,74373,824787,750414
SMI005-K03-B01-M03,1,2,Pf3D7_06_v3,1182560,1294070,111510
SMI005-K03-B01-M03,1,2,Pf3D7_07_v3,77194,449901,372707
SMI005-K03-B01-M03,1,2,Pf3D7_07_v3,480458,1380526,900068
SMI005-K03-B01-M03,1,2,Pf3D7_08_v3,75691,500772,425081
SMI005-K03-B01-M03,1,2,Pf3D7_08_v3,501390,1364499,863109
SMI005-K03-B01-M03,1,2,Pf3D7_09_v3,82153,1472334,1390181
SMI005-K03-B01-M03,1,2,Pf3D7_10_v3,70764,1254230,1183466
SMI005-K03-B01-M03,1,2,Pf3D7_10_v3,1513542,1570149,56607
SMI005-K03-B01-M03,1,2,Pf3D7_11_v3,110641,2003008,1892367
SMI005-K03-B01-M03,1,2,Pf3D7_12_v3,61435,2155095,2093660
SMI005-K03-B01-M03,1,2,Pf3D7_13_v3,77901,390249,312348
SMI005-K03-B01-M03,1,2,Pf3D7_13_v3,415785,1891015,1475230
SMI005-K03-B01-M03,1,2,Pf3D7_13_v3,2575636,2788579,212943
SMI005-K03-B01-M03,1,2,Pf3D7_14_v3,35796,3255607,3219811
SMI006-K03-B01-M01,0,1,Pf3D7_01_v3,95518,107823,12305
SMI006-K03-B01-M01,0,1,Pf3D7_01_v3,528425,567657,39232
SMI006-K03-B01-M01,0,1,Pf3D7_02_v3,109248,311729,202481
SMI006-K03-B01-M01,0,1,Pf3D7_02_v3,414955,480862,65907
SMI006-K03-B01-M01,0,1,Pf3D7_03_v3,236316,1002946,766630
SMI006-K03-B01-M01,0,1,Pf3D7_04_v3,91817,630569,538752
SMI006-K03-B01-M01,0,1,Pf3D7_04_v3,999012,1143965,144953
SMI006-K03-B01-M01,0,1,Pf3D7_05_v3,39872,131301,91429
SMI006-K03-B01-M01,0,1,Pf3D7_05_v3,1038517,1321074,282557
SMI006-K03-B01-M01,0,1,Pf3D7_06_v3,74373,411340,336967
SMI006-K03-B01-M01,0,1,Pf3D7_06_v3,833542,1294070,460528
SMI006-K03-B01-M01,0,1,Pf3D7_07_v3,77194,467225,390031
SMI006-K03-B01-M01,0,1,Pf3D7_07_v3,740566,1362917,622351
SMI006-K03-B01-M01,0,1,Pf3D7_07_v3,1380288,1380526,238
SMI006-K03-B01-M01,0,1,Pf3D7_08_v3,75691,424720,349029
SMI006-K03-B01-M01,0,1,Pf3D7_08_v3,468899,529764,60865
SMI006-K03-B01-M01,0,1,Pf3D7_08_v3,677481,826695,149214
SMI006-K03-B01-M01,0,1,Pf3D7_08_v3,1278610,1310759,32149
SMI006-K03-B01-M01,0,1,Pf3D7_09_v3,260914,290553,29639
SMI006-K03-B01-M01,0,1,Pf3D7_09_v3,1199384,1427949,228565
SMI006-K03-B01-M01,0,1,Pf3D7_10_v3,86696,714013,627317
SMI006-K03-B01-M01,0,1,Pf3D7_10_v3,1394114,1570149,176035
SMI006-K03-B01-M01,0,1,Pf3D7_11_v3,110641,427218,316577
SMI006-K03-B01-M01,0,1,Pf3D7_11_v3,1595699,2003008,407309
SMI006-K03-B01-M01,0,1,Pf3D7_12_v3,61435,749219,687784
SMI006-K03-B01-M01,0,1,Pf3D7_12_v3,1670700,2155095,484395
SMI006-K03-B01-M01,0,1,Pf3D7_13_v3,77901,106293,28392
SMI006-K03-B01-M01,0,1,Pf3D7_13_v3,390249,939344,549095
SMI006-K03-B01-M01,0,1,Pf3D7_14_v3,417069,448939,31870
SMI006-K03-B01-M01,0,2,Pf3D7_01_v3,107823,180068,72245
SMI006-K03-B01-M01,0,2,Pf3D7_02_v3,311729,414955,103226
SMI006-K03-B01-M01,0,2,Pf3D7_02_v3,480862,837378,356516
SMI006-K03-B01-M01,0,2,Pf3D7_02_v3,840716,862030,21314
SMI006-K03-B01-M01,0,2,Pf3D7_03_v3,71040,236316,165276
SMI006-K03-B01-M01,0,2,Pf3D7_04_v3,630569,667269,36700
SMI006-K03-B01-M01,0,2,Pf3D7_05_v3,131301,1038517,907216
SMI006-K03-B01-M01,0,2,Pf3D7_06_v3,411340,833542,422202
SMI006-K03-B01-M01,0,2,Pf3D7_07_v3,467225,489573,22348
SMI006-K03-B01-M01,0,2,Pf3D7_08_v3,426411,468899,42488
SMI006-K03-B01-M01,0,2,Pf3D7_09_v3,141489,182189,40700
SMI006-K03-B01-M01,0,2,Pf3D7_09_v3,290553,1199384,908831
SMI006-K03-B01-M01,0,2,Pf3D7_11_v3,427218,1595699,1168481
SMI006-K03-B01-M01,0,2,Pf3D7_13_v3,939344,1229674,290330
SMI006-K03-B01-M01,0,2,Pf3D7_13_v3,2115047,2575636,460589
SMI006-K03-B01-M01,0,2,Pf3D7_14_v3,448939,918720,469781
SMI006-K03-B01-M01,0,2,Pf3D7_14_v3,1226565,3255607,2029042
SMI006-K03-B01-M01,1,2,Pf3D7_01_v3,180068,528425,348357
SMI006-K03-B01-M01,1,2,Pf3D7_02_v3,837378,840716,3338
SMI006-K03-B01-M01,1,2,Pf3D7_04_v3,667269,999012,331743
SMI006-K03-B01-M01,1,2,Pf3D7_07_v3,489573,740566,250993
SMI006-K03-B01-M01,1,2,Pf3D7_07_v3,1362917,1380288,17371
SMI006-K03-B01-M01,1,2,Pf3D7_08_v3,424720,426411,1691
SMI006-K03-B01-M01,1,2,Pf3D7_08_v3,529764,677481,147717
SMI006-K03-B01-M01,1,2,Pf3D7_08_v3,826695,1278610,451915
SMI006-K03-B01-M01,1,2,Pf3D7_08_v3,1310759,1364499,53740
SMI006-K03-B01-M01,1,2,Pf3D7_09_v3,82153,141489,59336
SMI006-K03-B01-M01,1,2,Pf3D7_09_v3,182189,260914,78725
SMI006-K03-B01-M01,1,2,Pf3D7_09_v3,1427949,1472334,44385
SMI006-K03-B01-M01,1,2,Pf3D7_10_v3,70764,86696,15932
SMI006-K03-B01-M01,1,2,Pf3D7_10_v3,714013,1394114,680101
SMI006-K03-B01-M01,1,2,Pf3D7_12_v3,749219,1670700,921481
SMI006-K03-B01-M01,1,2,Pf3D7_13_v3,106293,390249,283956
SMI006-K03-B01-M01,1,2,Pf3D7_13_v3,1229674,2115047,885373
SMI006-K03-B01-M01,1,2,Pf3D7_13_v3,2575636,2788579,212943
SMI006-K03-B01-M01,1,2,Pf3D7_14_v3,35796,417069,381273
SMI006-K03-B01-M01,1,2,Pf3D7_14_v3,918720,1226565,307845
SMI008-K03-B01-M02,0,1,Pf3D7_01_v3,107823,178474,70651
SMI008-K03-B01-M02,0,1,Pf3D7_01_v3,238688,492563,253875
SMI008-K03-B01-M02,0,1,Pf3D7_02_v3,805840,862030,56190
SMI008-K03-B01-M02,0,1,Pf3D7_03_v3,71040,493631,422591
SMI008-K03-B01-M02,0,1,Pf3D7_04_v3,255939,415693,159754
SMI008-K03-B01-M02,0,1,Pf3D7_04_v3,537511,999012,461501
SMI008-K03-B01-M02,0,1,Pf3D7_05_v3,683316,831871,148555
SMI008-K03-B01-M02,0,1,Pf3D7_05_v3,1012192,1038517,26325
SMI008-K03-B01-M02,0,1,Pf3D7_05_v3,1113924,1263168,149244
SMI008-K03-B01-M02,0,1,Pf3D7_06_v3,796597,1268688,472091
SMI008-K03-B01-M02,0,1,Pf3D7_07_v3,449571,477426,27855
SMI008-K03-B01-M02,0,1,Pf3D7_07_v3,619957,1380526,760569
SMI008-K03-B01-M02,0,1,Pf3D7_08_v3,75691,473918,398227
SMI008-K03-B01-M02,0,1,Pf3D7_09_v3,416031,541853,125822
SMI008-K03-B01-M02,0,1,Pf3D7_09_v3,1140901,1270380,129479
SMI008-K03-B01-M02,0,1,Pf3D7_09_v3,1419000,1472334,53334
SMI008-K03-B01-M02,0,1,Pf3D7_10_v3,70764,341106,270342
SMI008-K03-B01-M02,0,1,Pf3D7_11_v3,778298,1126102,347804
SMI008-K03-B01-M02,0,1,Pf3D7_11_v3,1132096,1256754,124658
SMI008-K03-B01-M02,0,1,Pf3D7_12_v3,114173,1387200,1273027
SMI008-K03-B01-M02,0,1,Pf3D7_13_v3,77901,2575636,2497735
SMI008-K03-B01-M02,0,1,Pf3D7_14_v3,1156254,2857953,1701699
SMI008-K03-B01-M02,0,2,Pf3D7_01_v3,95518,238688,143170
SMI008-K03-B01-M02,0,2,Pf3D7_02_v3,290569,311475,20906
SMI008-K03-B01-M02,0,2,Pf3D7_02_v3,339959,862030,522071
SMI008-K03-B01-M02,0,2,Pf3D7_03_v3,71040,493631,422591
SMI008-K03-B01-M02,0,2,Pf3D7_04_v3,255939,1143965,888026
SMI008-K03-B01-M02,0,2,Pf3D7_05_v3,39872,224735,184863
SMI008-K03-B01-M02,0,2,Pf3D7_05_v3,1012192,1038517,26325
SMI008-K03-B01-M02,0,2,Pf3D7_05_v3,1113924,1204155,90231
SMI008-K03-B01-M02,0,2,Pf3D7_05_v3,1263168,1288644,25476
SMI008-K03-B01-M02,0,2,Pf3D7_06_v3,74373,592617,518244
SMI008-K03-B01-M02,0,2,Pf3D7_06_v3,619007,1111651,492644
SMI008-K03-B01-M02,0,2,Pf3D7_07_v3,477426,1265909,788483
SMI008-K03-B01-M02,0,2,Pf3D7_08_v3,164893,469434,304541
SMI008-K03-B01-M02,0,2,Pf3D7_08_v3,1138146,1278610,140464
SMI008-K03-B01-M02,0,2,Pf3D7_09_v3,1129679,1419000,289321
SMI008-K03-B01-M02,0,2,Pf3D7_11_v3,778298,1132096,353798
SMI008-K03-B01-M02,0,2,Pf3D7_11_v3,1394203,2003008,608805
SMI008-K03-B01-M02,0,2,Pf3D7_12_v3,61435,382400,320965
SMI008-K03-B01-M02,0,2,Pf3D7_12_v3,659823,1660673,1000850
SMI008-K03-B01-M02,0,2,Pf3D7_12_v3,1670700,2155095,484395
SMI008-K03-B01-M02,0,2,Pf3D7_13_v3,1103578,1528349,424771
SMI008-K03-B01-M02,0,2,Pf3D7_13_v3,1891015,2114168,223153
SMI008-K03-B01-M02,0,2,Pf3D7_13_v3,2575636,2579361,3725
SMI008-K03-B01-M02,0,2,Pf3D7_14_v3,393389,597940,204551
SMI008-K03-B01-M02,0,2,Pf3D7_14_v3,1156254,2857953,1701699
SMI008-K03-B01-M02,0,2,Pf3D7_14_v3,2859114,3255607,396493
SMI008-K03-B01-M02,1,2,Pf3D7_01_v3,107823,178474,70651
SMI008-K03-B01-M02,1,2,Pf3D7_02_v3,805840,862030,56190
SMI008-K03-B01-M02,1,2,Pf3D7_03_v3,71040,1002946,931906
SMI008-K03-B01-M02,1,2,Pf3D7_04_v3,91817,415693,323876
SMI008-K03-B01-M02,1,2,Pf3D7_04_v3,537511,999012,461501
SMI008-K03-B01-M02,1,2,Pf3D7_05_v3,224735,683316,458581
SMI008-K03-B01-M02,1,2,Pf3D7_05_v3,831871,1204155,372284
SMI008-K03-B01-M02,1,2,Pf3D7_06_v3,592617,619007,26390
SMI008-K03-B01-M02,1,2,Pf3D7_06_v3,796597,1111651,315054
SMI008-K03-B01-M02,1,2,Pf3D7_07_v3,619957,1265909,645952
SMI008-K03-B01-M02,1,2,Pf3D7_08_v3,164893,469434,304541
SMI008-K03-B01-M02,1,2,Pf3D7_08_v3,473918,1138146,664228
SMI008-K03-B01-M02,1,2,Pf3D7_09_v3,1140901,1270380,129479
SMI008-K03-B01-M02,1,2,Pf3D7_10_v3,341106,1570149,1229043
SMI008-K03-B01-M02,1,2,Pf3D7_11_v3,110641,1126102,1015461
SMI008-K03-B01-M02,1,2,Pf3D7_11_v3,1256754,1294584,37830
SMI008-K03-B01-M02,1,2,Pf3D7_12_v3,114173,382400,268227
SMI008-K03-B01-M02,1,2,Pf3D7_12_v3,659823,1387200,727377
SMI008-K03-B01-M02,1,2,Pf3D7_13_v3,1103578,1528349,424771
SMI008-K03-B01-M02,1,2,Pf3D7_13_v3,1891015,2114168,223153
SMI008-K03-B01-M02,1,2,Pf3D7_14_v3,597940,2859114,2261174
SMI009-K03-B01-M03,0,1,Pf3D7_01_v3,95518,567657,472139
SMI009-K03-B01-M03,0,1,Pf3D7_02_v3,109248,862030,752782
SMI009-K03-B01-M03,0,1,Pf3D7_03_v3,77481,1002946,925465
SMI009-K03-B01-M03,0,1,Pf3D7_04_v3,91817,615475,523658
SMI009-K03-B01-M03,0,1,Pf3D7_04_v3,767099,1006069,238970
SMI009-K03-B01-M03,0,1,Pf3D7_04_v3,1033018,1042985,9967
SMI009-K03-B01-M03,0,1,Pf3D7_04_v3,1102846,1143965,41119
SMI009-K03-B01-M03,0,1,Pf3D7_05_v3,39872,43677,3805
SMI009-K03-B01-M03,0,1,Pf3D7_05_v3,147419,1051701,904282
SMI009-K03-B01-M03,0,1,Pf3D7_05_v3,1172818,1321074,148256
SMI009-K03-B01-M03,0,1,Pf3D7_06_v3,74373,1294070,1219697
SMI009-K03-B01-M03,0,1,Pf3D7_07_v3,77194,126292,49098
SMI009-K03-B01-M03,0,1,Pf3D7_07_v3,480458,1066647,586189
SMI009-K03-B01-M03,0,1,Pf3D7_07_v3,1260728,1380526,119798
SMI009-K03-B01-M03,0,1,Pf3D7_08_v3,75691,467879,392188
SMI009-K03-B01-M03,0,1,Pf3D7_08_v3,913439,1364499,451060
SMI009-K03-B01-M03,0,1,Pf3D7_09_v3,82153,91183,9030
SMI009-K03-B01-M03,0,1,Pf3D7_09_v3,416031,686984,270953
SMI009-K03-B01-M03,0,1,Pf3D7_09_v3,1202246,1433621,231375
SMI009-K03-B01-M03,0,1,Pf3D7_10_v3,185257,1432783,1247526
SMI009-K03-B01-M03,0,1,Pf3D7_11_v3,487557,2003008,1515451
SMI009-K03-B01-M03,0,1,Pf3D7_12_v3,61435,122749,61314
SMI009-K03-B01-M03,0,1,Pf3D7_12_v3,382400,1559609,1177209
SMI009-K03-B01-M03,0,1,Pf3D7_12_v3,1661755,1670700,8945
SMI009-K03-B01-M03,0,1,Pf3D7_13_v3,319333,2575636,2256303
SMI009-K03-B01-M03,0,1,Pf3D7_14_v3,338453,711335,372882
SMI009-K03-B01-M03,0,1,Pf3D7_14_v3,918720,1034851,116131
SMI009-K03-B01-M03,0,1,Pf3D7_14_v3,1202249,2451029,1248780
SMI009-K03-B01-M03,0,1,Pf3D7_14_v3,2671772,3255607,583835
SMI009-K03-B01-M03,0,2,Pf3D7_01_v3,95518,567657,472139
SMI009-K03-B01-M03,0,2,Pf3D7_02_v3,109248,862030,752782
SMI009-K03-B01-M03,0,2,Pf3D7_03_v3,71040,1002946,931906
SMI009-K03-B01-M03,0,2,Pf3D7_04_v3,91817,255939,164122
SMI009-K03-B01-M03,0,2,Pf3D7_04_v3,999012,1143965,144953
SMI009-K03-B01-M03,0,2,Pf3D7_05_v3,39872,43677,3805
SMI009-K03-B01-M03,0,2,Pf3D7_05_v3,147419,1038517,891098
SMI009-K03-B01-M03,0,2,Pf3D7_05_v3,1172818,1321074,148256
SMI009-K03-B01-M03,0,2,Pf3D7_06_v3,74373,796597,722224
SMI009-K03-B01-M03,0,2,Pf3D7_06_v3,1111651,1294070,182419
SMI009-K03-B01-M03,0,2,Pf3D7_07_v3,77194,197008,119814
SMI009-K03-B01-M03,0,2,Pf3D7_07_v3,344469,619957,275488
SMI009-K03-B01-M03,0,2,Pf3D7_07_v3,1001981,1380526,378545
SMI009-K03-B01-M03,0,2,Pf3D7_08_v3,75691,399774,324083
SMI009-K03-B01-M03,0,2,Pf3D7_08_v3,478351,845431,367080
SMI009-K03-B01-M03,0,2,Pf3D7_08_v3,913439,1113495,200056
SMI009-K03-B01-M03,0,2,Pf3D7_08_v3,1194820,1364499,169679
SMI009-K03-B01-M03,0,2,Pf3D7_09_v3,82153,159227,77074
SMI009-K03-B01-M03,0,2,Pf3D7_09_v3,850094,926696,76602
SMI009-K03-B01-M03,0,2,Pf3D7_09_v3,1202246,1472334,270088
SMI009-K03-B01-M03,0,2,Pf3D7_10_v3,70764,1432783,1362019
SMI009-K03-B01-M03,0,2,Pf3D7_11_v3,130041,1294584,1164543
SMI009-K03-B01-M03,0,2,Pf3D7_11_v3,1749819,1841405,91586
SMI009-K03-B01-M03,0,2,Pf3D7_12_v3,122749,400368,277619
SMI009-K03-B01-M03,0,2,Pf3D7_12_v3,1670700,2155095,484395
SMI009-K03-B01-M03,0,2,Pf3D7_13_v3,77901,1419559,1341658
SMI009-K03-B01-M03,0,2,Pf3D7_13_v3,1970443,2575636,605193
SMI009-K03-B01-M03,0,2,Pf3D7_14_v3,75894,338453,262559
SMI009-K03-B01-M03,0,2,Pf3D7_14_v3,711335,1159255,447920
SMI009-K03-B01-M03,0,2,Pf3D7_14_v3,1984927,2006084,21157
SMI009-K03-B01-M03,0,2,Pf3D7_14_v3,2070946,2406952,336006
SMI009-K03-B01-M03,0,2,Pf3D7_14_v3,2671772,3255607,583835
SMI009-K03-B01-M03,1,2,Pf3D7_01_v3,95518,567657,472139
SMI009-K03-B01-M03,1,2,Pf3D7_02_v3,109248,862030,752782
SMI009-K03-B01-M03,1,2,Pf3D7_03_v3,77481,1002946,925465
SMI009-K03-B01-M03,1,2,Pf3D7_04_v3,91817,255939,164122
SMI009-K03-B01-M03,1,2,Pf3D7_04_v3,615475,767099,151624
SMI009-K03-B01-M03,1,2,Pf3D7_04_v3,999012,1006069,7057
SMI009-K03-B01-M03,1,2,Pf3D7_04_v3,1033018,1042985,9967
SMI009-K03-B01-M03,1,2,Pf3D7_04_v3,1102846,1143965,41119
SMI009-K03-B01-M03,1,2,Pf3D7_05_v3,39872,1038517,998645
SMI009-K03-B01-M03,1,2,Pf3D7_05_v3,1051701,1321074,269373
SMI009-K03-B01-M03,1,2,Pf3D7_06_v3,74373,796597,722224
SMI009-K03-B01-M03,1,2,Pf3D7_06_v3,1111651,1294070,182419
SMI009-K03-B01-M03,1,2,Pf3D7_07_v3,77194,126292,49098
SMI009-K03-B01-M03,1,2,Pf3D7_07_v3,197008,344469,147461
SMI009-K03-B01-M03,1,2,Pf3D7_07_v3,480458,619957,139499
SMI009-K03-B01-M03,1,2,Pf3D7_07_v3,1001981,1066647,64666
SMI009-K03-B01-M03,1,2,Pf3D7_07_v3,1260728,1380526,119798
SMI009-K03-B01-M03,1,2,Pf3D7_08_v3,75691,399774,324083
SMI009-K03-B01-M03,1,2,Pf3D7_08_v3,467879,478351,10472
SMI009-K03-B01-M03,1,2,Pf3D7_08_v3,845431,1113495,268064
SMI009-K03-B01-M03,1,2,Pf3D7_08_v3,1194820,1364499,169679
SMI009-K03-B01-M03,1,2,Pf3D7_09_v3,82153,91183,9030
SMI009-K03-B01-M03,1,2,Pf3D7_09_v3,159227,416031,256804
SMI009-K03-B01-M03,1,2,Pf3D7_09_v3,686984,850094,163110
SMI009-K03-B01-M03,1,2,Pf3D7_09_v3,926696,1433621,506925
SMI009-K03-B01-M03,1,2,Pf3D7_10_v3,185257,1570149,1384892
SMI009-K03-B01-M03,1,2,Pf3D7_11_v3,110641,130041,19400
SMI009-K03-B01-M03,1,2,Pf3D7_11_v3,487557,1294584,807027
SMI009-K03-B01-M03,1,2,Pf3D7_11_v3,1749819,1841405,91586
SMI009-K03-B01-M03,1,2,Pf3D7_12_v3,382400,400368,17968
SMI009-K03-B01-M03,1,2,Pf3D7_12_v3,1559609,1661755,102146
SMI009-K03-B01-M03,1,2,Pf3D7_13_v3,319333,1419559,1100226
SMI009-K03-B01-M03,1,2,Pf3D7_13_v3,1970443,2788579,818136
SMI009-K03-B01-M03,1,2,Pf3D7_14_v3,35796,75894,40098
SMI009-K03-B01-M03,1,2,Pf3D7_14_v3,918720,1034851,116131
SMI009-K03-B01-M03,1,2,Pf3D7_14_v3,1159255,1202249,42994
SMI009-K03-B01-M03,1,2,Pf3D7_14_v3,1984927,2006084,21157
SMI009-K03-B01-M03,1,2,Pf3D7_14_v3,2070946,2406952,336006
SMI009-K03-B01-M03,1,2,Pf3D7_14_v3,2451029,3255607,804578
SMI010-K03-B02-M03,0,1,Pf3D7_01_v3,95518,492563,397045
SMI010-K03-B02-M03,0,1,Pf3D7_01_v3,497883,567657,69774
SMI010-K03-B02-M03,0,1,Pf3D7_02_v3,109248,468251,359003
SMI010-K03-B02-M03,0,1,Pf3D7_02_v3,617482,843180,225698
SMI010-K03-B02-M03,0,1,Pf3D7_02_v3,858373,862030,3657
SMI010-K03-B02-M03,0,1,Pf3D7_03_v3,71040,1002946,931906
SMI010-K03-B02-M03,0,1,Pf3D7_04_v3,91817,1143965,1052148
SMI010-K03-B02-M03,0,1,Pf3D7_05_v3,39872,1308825,1268953
SMI010-K03-B02-M03,0,1,Pf3D7_06_v3,370698,1294070,923372
SMI010-K03-B02-M03,0,1,Pf3D7_07_v3,77194,1380526,1303332
SMI010-K03-B02-M03,0,1,Pf3D7_08_v3,75691,1364499,1288808
SMI010-K03-B02-M03,0,1,Pf3D7_09_v3,82153,1472334,1390181
SMI010-K03-B02-M03,0,1,Pf3D7_10_v3,70764,557657,486893
SMI010-K03-B02-M03,0,1,Pf3D7_10_v3,1254230,1570149,315919
SMI010-K03-B02-M03,0,1,Pf3D7_11_v3,110641,2003008,1892367
SMI010-K03-B02-M03,0,1,Pf3D7_12_v3,61435,382400,320965
SMI010-K03-B02-M03,0,1,Pf3D7_12_v3,682902,739074,56172
SMI010-K03-B02-M03,0,1,Pf3D7_12_v3,892467,1668778,776311
SMI010-K03-B02-M03,0,1,Pf3D7_12_v3,1670700,2155095,484395
SMI010-K03-B02-M03,0,1,Pf3D7_13_v3,77901,860281,782380
SMI010-K03-B02-M03,0,1,Pf3D7_13_v3,1367278,2788579,1421301
SMI010-K03-B02-M03,0,1,Pf3D7_14_v3,35796,1994906,1959110
SMI010-K03-B02-M03,0,1,Pf3D7_14_v3,2379662,2451029,71367
SMI010-K03-B02-M03,0,1,Pf3D7_14_v3,3193462,3255607,62145
SMI012-K03-B02-M01,0,1,Pf3D7_01_v3,95518,525598,430080
SMI012-K03-B02-M01,0,1,Pf3D7_02_v3,805840,862030,56190
SMI012-K03-B02-M01,0,1,Pf3D7_03_v3,71040,142126,71086
SMI012-K03-B02-M01,0,1,Pf3D7_04_v3,530965,667269,136304
SMI012-K03-B02-M01,0,1,Pf3D7_04_v3,803561,1143965,340404
SMI012-K03-B02-M01,0,1,Pf3D7_05_v3,39872,74191,34319
SMI012-K03-B02-M01,0,1,Pf3D7_05_v3,475567,476920,1353
SMI012-K03-B02-M01,0,1,Pf3D7_05_v3,683316,1288644,605328
SMI012-K03-B02-M01,0,1,Pf3D7_05_v3,1318836,1321074,2238
SMI012-K03-B02-M01,0,1,Pf3D7_06_v3,74373,312207,237834
SMI012-K03-B02-M01,0,1,Pf3D7_06_v3,382976,419369,36393
SMI012-K03-B02-M01,0,1,Pf3D7_06_v3,833542,883055,49513
SMI012-K03-B02-M01,0,1,Pf3D7_06_v3,1111651,1294070,182419
SMI012-K03-B02-M01,0,1,Pf3D7_07_v3,77194,619957,542763
SMI012-K03-B02-M01,0,1,Pf3D7_07_v3,1093607,1380526,286919
SMI012-K03-B02-M01,0,1,Pf3D7_08_v3,75691,425913,350222
SMI012-K03-B02-M01,0,1,Pf3D7_08_v3,1168116,1278610,110494
SMI012-K03-B02-M01,0,1,Pf3D7_09_v3,853207,1180235,327028
SMI012-K03-B02-M01,0,1,Pf3D7_10_v3,221006,740709,519703
SMI012-K03-B02-M01,0,1,Pf3D7_10_v3,1254230,1415066,160836
SMI012-K03-B02-M01,0,1,Pf3D7_11_v3,120802,1294584,1173782
SMI012-K03-B02-M01,0,1,Pf3D7_11_v3,1992743,2003008,10265
SMI012-K03-B02-M01,0,1,Pf3D7_12_v3,61435,807679,746244
SMI012-K03-B02-M01,0,1,Pf3D7_12_v3,857386,1670700,813314
SMI012-K03-B02-M01,0,1,Pf3D7_13_v3,102848,192974,90126
SMI012-K03-B02-M01,0,1,Pf3D7_14_v3,161602,624348,462746
SMI012-K03-B02-M01,0,1,Pf3D7_14_v3,918720,2231863,1313143
SMI014-K03-B02-M02,0,1,Pf3D7_01_v3,529726,532656,2930
SMI014-K03-B02-M02,0,1,Pf3D7_01_v3,536003,567657,31654
SMI014-K03-B02-M02,0,1,Pf3D7_02_v3,109248,468251,359003
SMI014-K03-B02-M02,0,1,Pf3D7_02_v3,630737,862030,231293
SMI014-K03-B02-M02,0,1,Pf3D7_03_v3,71040,143195,72155
SMI014-K03-B02-M02,0,1,Pf3D7_03_v3,221547,1002946,781399
SMI014-K03-B02-M02,0,1,Pf3D7_04_v3,91817,133039,41222
SMI014-K03-B02-M02,0,1,Pf3D7_04_v3,255939,999012,743073
SMI014-K03-B02-M02,0,1,Pf3D7_04_v3,1036984,1141503,104519
SMI014-K03-B02-M02,0,1,Pf3D7_05_v3,383150,550283,167133
SMI014-K03-B02-M02,0,1,Pf3D7_05_v3,1184046,1321074,137028
SMI014-K03-B02-M02,0,1,Pf3D7_06_v3,74373,815124,740751
SMI014-K03-B02-M02,0,1,Pf3D7_06_v3,833542,883055,49513
SMI014-K03-B02-M02,0,1,Pf3D7_06_v3,1111651,1284838,173187
SMI014-K03-B02-M02,0,1,Pf3D7_07_v3,240864,466102,225238
SMI014-K03-B02-M02,0,1,Pf3D7_07_v3,480458,496935,16477
SMI014-K03-B02-M02,0,1,Pf3D7_07_v3,1234151,1362913,128762
SMI014-K03-B02-M02,0,1,Pf3D7_08_v3,1099848,1313796,213948
SMI014-K03-B02-M02,0,1,Pf3D7_09_v3,225542,1436348,1210806
SMI014-K03-B02-M02,0,1,Pf3D7_10_v3,75884,1570149,1494265
SMI014-K03-B02-M02,0,1,Pf3D7_11_v3,110641,779931,669290
SMI014-K03-B02-M02,0,1,Pf3D7_11_v3,1114979,1429069,314090
SMI014-K03-B02-M02,0,1,Pf3D7_12_v3,122749,749219,626470
SMI014-K03-B02-M02,0,1,Pf3D7_12_v3,1661867,2155095,493228
SMI014-K03-B02-M02,0,1,Pf3D7_13_v3,77901,285932,208031
SMI014-K03-B02-M02,0,1,Pf3D7_13_v3,1619394,2020792,401398
SMI014-K03-B02-M02,0,1,Pf3D7_14_v3,501766,918720,416954
SMI015-K03-B02-M02,0,1,Pf3D7_01_v3,125303,180328,55025
SMI015-K03-B02-M02,0,1,Pf3D7_01_v3,290195,487057,196862
SMI015-K03-B02-M02,0,1,Pf3D7_01_v3,528425,567657,39232
SMI015-K03-B02-M02,0,1,Pf3D7_02_v3,109248,206291,97043
SMI015-K03-B02-M02,0,1,Pf3D7_02_v3,468251,805840,337589
SMI015-K03-B02-M02,0,1,Pf3D7_03_v3,96841,1002946,906105
SMI015-K03-B02-M02,0,1,Pf3D7_04_v3,91817,375057,283240
SMI015-K03-B02-M02,0,1,Pf3D7_04_v3,544797,647776,102979
SMI015-K03-B02-M02,0,1,Pf3D7_04_v3,650240,812570,162330
SMI015-K03-B02-M02,0,1,Pf3D7_04_v3,999012,1143965,144953
SMI015-K03-B02-M02,0,1,Pf3D7_05_v3,39872,224735,184863
SMI015-K03-B02-M02,0,1,Pf3D7_05_v3,383150,1321074,937924
SMI015-K03-B02-M02,0,1,Pf3D7_06_v3,74373,1294070,1219697
SMI015-K03-B02-M02,0,1,Pf3D7_07_v3,77194,147345,70151
SMI015-K03-B02-M02,0,1,Pf3D7_07_v3,480458,618007,137549
SMI015-K03-B02-M02,0,1,Pf3D7_07_v3,619957,1380466,760509
SMI015-K03-B02-M02,0,1,Pf3D7_08_v3,229173,1113495,884322
SMI015-K03-B02-M02,0,1,Pf3D7_08_v3,1176482,1364499,188017
SMI015-K03-B02-M02,0,1,Pf3D7_09_v3,82153,1472334,1390181
SMI015-K03-B02-M02,0,1,Pf3D7_10_v3,70764,1254230,1183466
SMI015-K03-B02-M02,0,1,Pf3D7_10_v3,1385894,1570149,184255
SMI015-K03-B02-M02,0,1,Pf3D7_11_v3,110641,427218,316577
SMI015-K03-B02-M02,0,1,Pf3D7_11_v3,778298,2003008,1224710
SMI015-K03-B02-M02,0,1,Pf3D7_12_v3,61435,2155095,2093660
SMI015-K03-B02-M02,0,1,Pf3D7_13_v3,77901,444696,366795
SMI015-K03-B02-M02,0,1,Pf3D7_13_v3,2575636,2788579,212943
SMI015-K03-B02-M02,0,1,Pf3D7_14_v3,35796,185202,149406
SMI015-K03-B02-M02,0,1,Pf3D7_14_v3,201791,3254381,3052590
SMI016-K03-B02-M01,0,1,Pf3D7_01_v3,95518,178474,82956
SMI016-K03-B02-M01,0,1,Pf3D7_01_v3,487895,567657,79762
SMI016-K03-B02-M01,0,1,Pf3D7_02_v3,109248,805840,696592
SMI016-K03-B02-M01,0,1,Pf3D7_03_v3,414983,654721,239738
SMI016-K03-B02-M01,0,1,Pf3D7_03_v3,849850,1002946,153096
SMI016-K03-B02-M01,0,1,Pf3D7_04_v3,91817,883380,791563
SMI016-K03-B02-M01,0,1,Pf3D7_04_v3,999012,1143965,144953
SMI016-K03-B02-M01,0,1,Pf3D7_05_v3,39872,198958,159086
SMI016-K03-B02-M01,0,1,Pf3D7_05_v3,350957,1308825,957868
SMI016-K03-B02-M01,0,1,Pf3D7_07_v3,900965,1380526,479561
SMI016-K03-B02-M01,0,1,Pf3D7_08_v3,75691,83708,8017
SMI016-K03-B02-M01,0,1,Pf3D7_08_v3,666328,1278610,612282
SMI016-K03-B02-M01,0,1,Pf3D7_10_v3,1254230,1410916,156686
SMI016-K03-B02-M01,0,1,Pf3D7_11_v3,115512,1887740,1772228
SMI016-K03-B02-M01,0,1,Pf3D7_12_v3,803229,907264,104035
SMI016-K03-B02-M01,0,1,Pf3D7_13_v3,2478581,2575636,97055
SMI016-K03-B02-M01,0,1,Pf3D7_14_v3,1396018,3255607,1859589
SMI017-K03-B02-M03,0,1,Pf3D7_01_v3,95518,567657,472139
SMI017-K03-B02-M03,0,1,Pf3D7_02_v3,109248,297229,187981
SMI017-K03-B02-M03,0,1,Pf3D7_02_v3,468251,862030,393779
SMI017-K03-B02-M03,0,1,Pf3D7_03_v3,71040,183105,112065
SMI017-K03-B02-M03,0,1,Pf3D7_03_v3,414967,878750,463783
SMI017-K03-B02-M03,0,1,Pf3D7_04_v3,255939,830755,574816
SMI017-K03-B02-M03,0,1,Pf3D7_04_v3,999012,1143965,144953
SMI017-K03-B02-M03,0,1,Pf3D7_05_v3,39872,561244,521372
SMI017-K03-B02-M03,0,1,Pf3D7_05_v3,683316,1038517,355201
SMI017-K03-B02-M03,0,1,Pf3D7_05_v3,1043303,1187921,144618
SMI017-K03-B02-M03,0,1,Pf3D7_05_v3,1204155,1321074,116919
SMI017-K03-B02-M03,0,1,Pf3D7_06_v3,74373,690352,615979
SMI017-K03-B02-M03,0,1,Pf3D7_06_v3,796597,1111651,315054
SMI017-K03-B02-M03,0,1,Pf3D7_06_v3,1283406,1294070,10664
SMI017-K03-B02-M03,0,1,Pf3D7_07_v3,77194,376423,299229
SMI017-K03-B02-M03,0,1,Pf3D7_07_v3,465579,1380526,914947
SMI017-K03-B02-M03,0,1,Pf3D7_08_v3,75691,1364499,1288808
SMI017-K03-B02-M03,0,1,Pf3D7_09_v3,82153,888810,806657
SMI017-K03-B02-M03,0,1,Pf3D7_10_v3,113505,1254230,1140725
SMI017-K03-B02-M03,0,1,Pf3D7_10_v3,1318156,1570149,251993
SMI017-K03-B02-M03,0,1,Pf3D7_11_v3,110641,474387,363746
SMI017-K03-B02-M03,0,1,Pf3D7_11_v3,1294584,1749819,455235
SMI017-K03-B02-M03,0,1,Pf3D7_12_v3,122749,2155095,2032346
SMI017-K03-B02-M03,0,1,Pf3D7_13_v3,77901,1103578,1025677
SMI017-K03-B02-M03,0,1,Pf3D7_13_v3,1891015,2788579,897564
SMI017-K03-B02-M03,0,1,Pf3D7_14_v3,35796,2451029,2415233
SMI017-K03-B02-M03,0,1,Pf3D7_14_v3,2873645,3255607,381962
SMI021-K03-B02-M01,0,1,Pf3D7_02_v3,371009,414955,43946
SMI021-K03-B02-M01,0,1,Pf3D7_03_v3,118956,615424,496468
SMI021-K03-B02-M01,0,1,Pf3D7_04_v3,255939,891051,635112
SMI021-K03-B02-M01,0,1,Pf3D7_04_v3,1142167,1143965,1798
SMI021-K03-B02-M01,0,1,Pf3D7_05_v3,39872,92675,52803
SMI021-K03-B02-M01,0,1,Pf3D7_05_v3,1043303,1217053,173750
SMI021-K03-B02-M01,0,1,Pf3D7_06_v3,304643,542924,238281
SMI021-K03-B02-M01,0,1,Pf3D7_06_v3,1111651,1269174,157523
SMI021-K03-B02-M01,0,1,Pf3D7_07_v3,619957,884384,264427
SMI021-K03-B02-M01,0,1,Pf3D7_07_v3,1058754,1234265,175511
SMI021-K03-B02-M01,0,1,Pf3D7_08_v3,1278610,1325177,46567
SMI021-K03-B02-M01,0,1,Pf3D7_09_v3,123040,723918,600878
SMI021-K03-B02-M01,0,1,Pf3D7_11_v3,265114,1986200,1721086
SMI021-K03-B02-M01,0,1,Pf3D7_12_v3,749219,1670700,921481
SMI021-K03-B02-M01,0,1,Pf3D7_14_v3,3125881,3255607,129726
SMI023-K03-B01-M02,0,1,Pf3D7_01_v3,95518,496106,400588
SMI023-K03-B01-M02,0,1,Pf3D7_01_v3,516312,529726,13414
SMI023-K03-B01-M02,0,1,Pf3D7_02_v3,372420,503316,130896
SMI023-K03-B01-M02,0,1,Pf3D7_02_v3,630545,646122,15577
SMI023-K03-B01-M02,0,1,Pf3D7_02_v3,805840,862030,56190
SMI023-K03-B01-M02,0,1,Pf3D7_03_v3,71040,1002946,931906
SMI023-K03-B01-M02,0,1,Pf3D7_04_v3,91817,140510,48693
SMI023-K03-B01-M02,0,1,Pf3D7_04_v3,255939,796416,540477
SMI023-K03-B01-M02,0,1,Pf3D7_05_v3,921466,931606,10140
SMI023-K03-B01-M02,0,1,Pf3D7_05_v3,1204155,1217053,12898
SMI023-K03-B01-M02,0,1,Pf3D7_06_v3,184028,202296,18268
SMI023-K03-B01-M02,0,1,Pf3D7_06_v3,542221,1241113,698892
SMI023-K03-B01-M02,0,1,Pf3D7_06_v3,1269383,1283913,14530
SMI023-K03-B01-M02,0,1,Pf3D7_07_v3,420336,480458,60122
SMI023-K03-B01-M02,0,1,Pf3D7_07_v3,619957,1380526,760569
SMI023-K03-B01-M02,0,1,Pf3D7_08_v3,75691,781506,705815
SMI023-K03-B01-M02,0,1,Pf3D7_08_v3,801085,1364499,563414
SMI023-K03-B01-M02,0,1,Pf3D7_09_v3,82153,1472334,1390181
SMI023-K03-B01-M02,0,1,Pf3D7_10_v3,70764,1513542,1442778
SMI023-K03-B01-M02,0,1,Pf3D7_11_v3,186489,1294584,1108095
SMI023-K03-B01-M02,0,1,Pf3D7_12_v3,718550,1397156,678606
SMI023-K03-B01-M02,0,1,Pf3D7_12_v3,1670700,2155095,484395
SMI023-K03-B01-M02,0,1,Pf3D7_13_v3,77901,106161,28260
SMI023-K03-B01-M02,0,1,Pf3D7_13_v3,305484,341070,35586
SMI023-K03-B01-M02,0,1,Pf3D7_13_v3,367468,1359289,991821
SMI023-K03-B01-M02,0,1,Pf3D7_13_v3,1595988,1891015,295027
SMI023-K03-B01-M02,0,1,Pf3D7_13_v3,1976438,2788579,812141
SMI023-K03-B01-M02,0,1,Pf3D7_14_v3,35796,918720,882924
SMI023-K03-B01-M02,0,1,Pf3D7_14_v3,1159875,2929017,1769142
SMI023-K03-B01-M02,0,1,Pf3D7_14_v3,3084224,3255607,171383
SMI023-K03-B01-M02,0,2,Pf3D7_01_v3,95518,513707,418189
SMI023-K03-B01-M02,0,2,Pf3D7_01_v3,516312,529726,13414
SMI023-K03-B01-M02,0,2,Pf3D7_02_v3,372420,503316,130896
SMI023-K03-B01-M02,0,2,Pf3D7_02_v3,630545,646122,15577
SMI023-K03-B01-M02,0,2,Pf3D7_02_v3,843180,862030,18850
SMI023-K03-B01-M02,0,2,Pf3D7_03_v3,71040,170475,99435
SMI023-K03-B01-M02,0,2,Pf3D7_04_v3,140510,255939,115429
SMI023-K03-B01-M02,0,2,Pf3D7_04_v3,426436,796416,369980
SMI023-K03-B01-M02,0,2,Pf3D7_05_v3,92221,118209,25988
SMI023-K03-B01-M02,0,2,Pf3D7_05_v3,329613,1038517,708904
SMI023-K03-B01-M02,0,2,Pf3D7_05_v3,1204155,1217053,12898
SMI023-K03-B01-M02,0,2,Pf3D7_06_v3,184028,202296,18268
SMI023-K03-B01-M02,0,2,Pf3D7_06_v3,312207,542221,230014
SMI023-K03-B01-M02,0,2,Pf3D7_06_v3,796597,1269383,472786
SMI023-K03-B01-M02,0,2,Pf3D7_06_v3,1283913,1294070,10157
SMI023-K03-B01-M02,0,2,Pf3D7_07_v3,77194,122637,45443
SMI023-K03-B01-M02,0,2,Pf3D7_07_v3,420336,480458,60122
SMI023-K03-B01-M02,0,2,Pf3D7_07_v3,619957,1380526,760569
SMI023-K03-B01-M02,0,2,Pf3D7_08_v3,75691,781506,705815
SMI023-K03-B01-M02,0,2,Pf3D7_08_v3,1113495,1364499,251004
SMI023-K03-B01-M02,0,2,Pf3D7_09_v3,82153,1472334,1390181
SMI023-K03-B01-M02,0,2,Pf3D7_10_v3,70764,317581,246817
SMI023-K03-B01-M02,0,2,Pf3D7_10_v3,631276,1570149,938873
SMI023-K03-B01-M02,0,2,Pf3D7_11_v3,110641,186489,75848
SMI023-K03-B01-M02,0,2,Pf3D7_11_v3,920192,1294584,374392
SMI023-K03-B01-M02,0,2,Pf3D7_11_v3,1887740,2003008,115268
SMI023-K03-B01-M02,0,2,Pf3D7_12_v3,61435,2155095,2093660
SMI023-K03-B01-M02,0,2,Pf3D7_13_v3,77901,156176,78275
SMI023-K03-B01-M02,0,2,Pf3D7_13_v3,305484,341070,35586
SMI023-K03-B01-M02,0,2,Pf3D7_13_v3,367468,425672,58204
SMI023-K03-B01-M02,0,2,Pf3D7_13_v3,651941,1359289,707348
SMI023-K03-B01-M02,0,2,Pf3D7_13_v3,1595988,1891015,295027
SMI023-K03-B01-M02,0,2,Pf3D7_13_v3,1976438,2575636,599198
SMI023-K03-B01-M02,0,2,Pf3D7_13_v3,2742156,2788579,46423
SMI023-K03-B01-M02,0,2,Pf3D7_14_v3,35796,918720,882924
SMI023-K03-B01-M02,0,2,Pf3D7_14_v3,1159875,3084224,1924349
SMI023-K03-B01-M02,0,2,Pf3D7_14_v3,3121290,3255607,134317
SMI023-K03-B01-M02,1,2,Pf3D7_01_v3,95518,496106,400588
SMI023-K03-B01-M02,1,2,Pf3D7_01_v3,513707,567657,53950
SMI023-K03-B01-M02,1,2,Pf3D7_02_v3,109248,805840,696592
SMI023-K03-B01-M02,1,2,Pf3D7_02_v3,843180,862030,18850
SMI023-K03-B01-M02,1,2,Pf3D7_03_v3,71040,170475,99435
SMI023-K03-B01-M02,1,2,Pf3D7_04_v3,426436,1143965,717529
SMI023-K03-B01-M02,1,2,Pf3D7_05_v3,39872,92221,52349
SMI023-K03-B01-M02,1,2,Pf3D7_05_v3,118209,329613,211404
SMI023-K03-B01-M02,1,2,Pf3D7_05_v3,921466,931606,10140
SMI023-K03-B01-M02,1,2,Pf3D7_05_v3,1038517,1321074,282557
SMI023-K03-B01-M02,1,2,Pf3D7_06_v3,74373,312207,237834
SMI023-K03-B01-M02,1,2,Pf3D7_06_v3,796597,1241113,444516
SMI023-K03-B01-M02,1,2,Pf3D7_07_v3,122637,1380526,1257889
SMI023-K03-B01-M02,1,2,Pf3D7_08_v3,75691,801085,725394
SMI023-K03-B01-M02,1,2,Pf3D7_08_v3,1113495,1364499,251004
SMI023-K03-B01-M02,1,2,Pf3D7_09_v3,82153,1472334,1390181
SMI023-K03-B01-M02,1,2,Pf3D7_10_v3,70764,317581,246817
SMI023-K03-B01-M02,1,2,Pf3D7_10_v3,631276,1513542,882266
SMI023-K03-B01-M02,1,2,Pf3D7_11_v3,920192,1887740,967548
SMI023-K03-B01-M02,1,2,Pf3D7_12_v3,718550,1397156,678606
SMI023-K03-B01-M02,1,2,Pf3D7_12_v3,1670700,2155095,484395
SMI023-K03-B01-M02,1,2,Pf3D7_13_v3,77901,106161,28260
SMI023-K03-B01-M02,1,2,Pf3D7_13_v3,156176,425672,269496
SMI023-K03-B01-M02,1,2,Pf3D7_13_v3,651941,2575636,1923695
SMI023-K03-B01-M02,1,2,Pf3D7_13_v3,2742156,2788579,46423
SMI023-K03-B01-M02,1,2,Pf3D7_14_v3,35796,2929017,2893221
SMI023-K03-B01-M02,1,2,Pf3D7_14_v3,3121290,3255607,134317
SMI024-K03-B02-M02,0,1,Pf3D7_01_v3,95518,567657,472139
SMI024-K03-B02-M02,0,1,Pf3D7_02_v3,109248,213574,104326
SMI024-K03-B02-M02,0,1,Pf3D7_02_v3,245174,468251,223077
SMI024-K03-B02-M02,0,1,Pf3D7_03_v3,204732,311072,106340
SMI024-K03-B02-M02,0,1,Pf3D7_03_v3,654499,1002946,348447
SMI024-K03-B02-M02,0,1,Pf3D7_04_v3,91817,255939,164122
SMI024-K03-B02-M02,0,1,Pf3D7_04_v3,284311,420218,135907
SMI024-K03-B02-M02,0,1,Pf3D7_04_v3,488769,888001,399232
SMI024-K03-B02-M02,0,1,Pf3D7_04_v3,902548,1036984,134436
SMI024-K03-B02-M02,0,1,Pf3D7_05_v3,796714,1038517,241803
SMI024-K03-B02-M02,0,1,Pf3D7_05_v3,1204155,1321074,116919
SMI024-K03-B02-M02,0,1,Pf3D7_06_v3,74373,231858,157485
SMI024-K03-B02-M02,0,1,Pf3D7_06_v3,797947,869449,71502
SMI024-K03-B02-M02,0,1,Pf3D7_06_v3,1111651,1294070,182419
SMI024-K03-B02-M02,0,1,Pf3D7_07_v3,77194,619957,542763
SMI024-K03-B02-M02,0,1,Pf3D7_07_v3,821413,1380526,559113
SMI024-K03-B02-M02,0,1,Pf3D7_08_v3,75691,1363159,1287468
SMI024-K03-B02-M02,0,1,Pf3D7_09_v3,416031,1472334,1056303
SMI024-K03-B02-M02,0,1,Pf3D7_10_v3,70764,808864,738100
SMI024-K03-B02-M02,0,1,Pf3D7_10_v3,1254230,1570149,315919
SMI024-K03-B02-M02,0,1,Pf3D7_11_v3,110641,1294584,1183943
SMI024-K03-B02-M02,0,1,Pf3D7_11_v3,1294703,1991090,696387
SMI024-K03-B02-M02,0,1,Pf3D7_11_v3,1993165,2001759,8594
SMI024-K03-B02-M02,0,1,Pf3D7_12_v3,382400,727996,345596
SMI024-K03-B02-M02,0,1,Pf3D7_12_v3,762514,2155095,1392581
SMI024-K03-B02-M02,0,1,Pf3D7_13_v3,77901,106668,28767
SMI024-K03-B02-M02,0,1,Pf3D7_13_v3,1499527,2788579,1289052
SMI024-K03-B02-M02,0,1,Pf3D7_14_v3,35796,407383,371587
SMI024-K03-B02-M02,0,1,Pf3D7_14_v3,429723,918720,488997
SMI024-K03-B02-M02,0,1,Pf3D7_14_v3,2020660,3255607,1234947
SMI026-K03-B01-M01,0,1,Pf3D7_01_v3,528580,567657,39077
SMI026-K03-B01-M01,0,1,Pf3D7_02_v3,109248,179137,69889
SMI026-K03-B01-M01,0,1,Pf3D7_02_v3,805840,840716,34876
SMI026-K03-B01-M01,0,1,Pf3D7_03_v3,140678,361403,220725
SMI026-K03-B01-M01,0,1,Pf3D7_03_v3,510782,1002946,492164
SMI026-K03-B01-M01,0,1,Pf3D7_04_v3,91817,255939,164122
SMI026-K03-B01-M01,0,1,Pf3D7_05_v3,1288644,1321074,32430
SMI026-K03-B01-M01,0,1,Pf3D7_06_v3,74373,577389,503016
SMI026-K03-B01-M01,0,1,Pf3D7_07_v3,460942,619957,159015
SMI026-K03-B01-M01,0,1,Pf3D7_08_v3,1103279,1278610,175331
SMI026-K03-B01-M01,0,1,Pf3D7_09_v3,1436348,1472334,35986
SMI026-K03-B01-M01,0,1,Pf3D7_10_v3,70764,574773,504009
SMI026-K03-B01-M01,0,1,Pf3D7_10_v3,1074462,1254230,179768
SMI026-K03-B01-M01,0,1,Pf3D7_11_v3,474387,1294753,820366
SMI026-K03-B01-M01,0,1,Pf3D7_12_v3,1281594,1670700,389106
SMI026-K03-B01-M01,0,1,Pf3D7_13_v3,194874,585306,390432
SMI026-K03-B01-M01,0,1,Pf3D7_13_v3,2575636,2666855,91219
SMI026-K03-B01-M01,0,1,Pf3D7_14_v3,918720,1948269,1029549
SMI026-K03-B01-M01,0,2,Pf3D7_02_v3,190531,805840,615309
SMI026-K03-B01-M01,0,2,Pf3D7_04_v3,667395,887796,220401
SMI026-K03-B01-M01,0,2,Pf3D7_04_v3,999012,1136848,137836
SMI026-K03-B01-M01,0,2,Pf3D7_05_v3,929884,1038517,108633
SMI026-K03-B01-M01,0,2,Pf3D7_05_v3,1175497,1288644,113147
SMI026-K03-B01-M01,0,2,Pf3D7_06_v3,874163,1111651,237488
SMI026-K03-B01-M01,0,2,Pf3D7_07_v3,619957,1380526,760569
SMI026-K03-B01-M01,0,2,Pf3D7_08_v3,75691,83708,8017
SMI026-K03-B01-M01,0,2,Pf3D7_08_v3,422355,467879,45524
SMI026-K03-B01-M01,0,2,Pf3D7_08_v3,916406,1103279,186873
SMI026-K03-B01-M01,0,2,Pf3D7_08_v3,1278610,1311354,32744
SMI026-K03-B01-M01,0,2,Pf3D7_09_v3,202903,271024,68121
SMI026-K03-B01-M01,0,2,Pf3D7_09_v3,500646,1436348,935702
SMI026-K03-B01-M01,0,2,Pf3D7_10_v3,574773,1074462,499689
SMI026-K03-B01-M01,0,2,Pf3D7_12_v3,382400,1281594,899194
SMI026-K03-B01-M01,0,2,Pf3D7_12_v3,1670700,2155095,484395
SMI026-K03-B01-M01,0,2,Pf3D7_13_v3,77901,194874,116973
SMI026-K03-B01-M01,0,2,Pf3D7_14_v3,3098922,3255607,156685
SMI026-K03-B01-M01,1,2,Pf3D7_01_v3,95518,528580,433062
SMI026-K03-B01-M01,1,2,Pf3D7_02_v3,179137,190531,11394
SMI026-K03-B01-M01,1,2,Pf3D7_02_v3,840716,862030,21314
SMI026-K03-B01-M01,1,2,Pf3D7_03_v3,71040,140678,69638
SMI026-K03-B01-M01,1,2,Pf3D7_03_v3,361403,510782,149379
SMI026-K03-B01-M01,1,2,Pf3D7_04_v3,255939,667395,411456
SMI026-K03-B01-M01,1,2,Pf3D7_04_v3,887796,999012,111216
SMI026-K03-B01-M01,1,2,Pf3D7_04_v3,1136848,1143965,7117
SMI026-K03-B01-M01,1,2,Pf3D7_05_v3,39872,929884,890012
SMI026-K03-B01-M01,1,2,Pf3D7_05_v3,1038517,1175497,136980
SMI026-K03-B01-M01,1,2,Pf3D7_06_v3,577389,874163,296774
SMI026-K03-B01-M01,1,2,Pf3D7_06_v3,1111651,1294070,182419
SMI026-K03-B01-M01,1,2,Pf3D7_07_v3,77194,460942,383748
SMI026-K03-B01-M01,1,2,Pf3D7_08_v3,83708,422355,338647
SMI026-K03-B01-M01,1,2,Pf3D7_08_v3,467879,916406,448527
SMI026-K03-B01-M01,1,2,Pf3D7_08_v3,1311354,1364499,53145
SMI026-K03-B01-M01,1,2,Pf3D7_09_v3,82153,202903,120750
SMI026-K03-B01-M01,1,2,Pf3D7_09_v3,271024,500646,229622
SMI026-K03-B01-M01,1,2,Pf3D7_10_v3,1254230,1570149,315919
SMI026-K03-B01-M01,1,2,Pf3D7_11_v3,110641,474387,363746
SMI026-K03-B01-M01,1,2,Pf3D7_11_v3,1294753,2003008,708255
SMI026-K03-B01-M01,1,2,Pf3D7_12_v3,61435,382400,320965
SMI026-K03-B01-M01,1,2,Pf3D7_13_v3,585306,2575636,1990330
SMI026-K03-B01-M01,1,2,Pf3D7_13_v3,2666855,2788579,121724
SMI026-K03-B01-M01,1,2,Pf3D7_14_v3,35796,918720,882924
SMI026-K03-B01-M01,1,2,Pf3D7_14_v3,1948269,3098922,1150653
SMI028-K03-B01-M01,0,1,Pf3D7_01_v3,95518,155877,60359
SMI028-K03-B01-M01,0,1,Pf3D7_01_v3,180172,190739,10567
SMI028-K03-B01-M01,0,1,Pf3D7_01_v3,530378,567657,37279
SMI028-K03-B01-M01,0,1,Pf3D7_02_v3,109248,290666,181418
SMI028-K03-B01-M01,0,1,Pf3D7_02_v3,805840,840716,34876
SMI028-K03-B01-M01,0,1,Pf3D7_05_v3,62996,92221,29225
SMI028-K03-B01-M01,0,1,Pf3D7_05_v3,110728,288859,178131
SMI028-K03-B01-M01,0,1,Pf3D7_06_v3,635935,1294070,658135
SMI028-K03-B01-M01,0,1,Pf3D7_07_v3,77194,619398,542204
SMI028-K03-B01-M01,0,1,Pf3D7_08_v3,708827,1120456,411629
SMI028-K03-B01-M01,0,1,Pf3D7_11_v3,683965,1637389,953424
SMI028-K03-B01-M01,0,1,Pf3D7_12_v3,382400,1670700,1288300
SMI028-K03-B01-M01,0,1,Pf3D7_13_v3,1682933,2788579,1105646
SMI028-K03-B01-M01,0,1,Pf3D7_14_v3,35796,3255607,3219811
SMI028-K03-B01-M01,0,2,Pf3D7_01_v3,95518,567657,472139
SMI028-K03-B01-M01,0,2,Pf3D7_02_v3,109248,290666,181418
SMI028-K03-B01-M01,0,2,Pf3D7_02_v3,805840,840716,34876
SMI028-K03-B01-M01,0,2,Pf3D7_04_v3,255939,508397,252458
SMI028-K03-B01-M01,0,2,Pf3D7_04_v3,512825,615475,102650
SMI028-K03-B01-M01,0,2,Pf3D7_04_v3,1136615,1143965,7350
SMI028-K03-B01-M01,0,2,Pf3D7_05_v3,39872,1321074,1281202
SMI028-K03-B01-M01,0,2,Pf3D7_06_v3,74373,1294070,1219697
SMI028-K03-B01-M01,0,2,Pf3D7_07_v3,77194,619957,542763
SMI028-K03-B01-M01,0,2,Pf3D7_08_v3,708827,1120456,411629
SMI028-K03-B01-M01,0,2,Pf3D7_08_v3,1278610,1364499,85889
SMI028-K03-B01-M01,0,2,Pf3D7_09_v3,82153,158528,76375
SMI028-K03-B01-M01,0,2,Pf3D7_11_v3,649388,2003008,1353620
SMI028-K03-B01-M01,0,2,Pf3D7_12_v3,61435,1670700,1609265
SMI028-K03-B01-M01,0,2,Pf3D7_13_v3,1682933,2788579,1105646
SMI028-K03-B01-M01,0,2,Pf3D7_14_v3,35796,3255607,3219811
SMI028-K03-B01-M01,1,2,Pf3D7_01_v3,95518,155877,60359
SMI028-K03-B01-M01,1,2,Pf3D7_01_v3,180172,190739,10567
SMI028-K03-B01-M01,1,2,Pf3D7_01_v3,530378,567657,37279
SMI028-K03-B01-M01,1,2,Pf3D7_02_v3,109248,862030,752782
SMI028-K03-B01-M01,1,2,Pf3D7_03_v3,71040,332302,261262
SMI028-K03-B01-M01,1,2,Pf3D7_03_v3,341291,357947,16656
SMI028-K03-B01-M01,1,2,Pf3D7_04_v3,883288,891051,7763
SMI028-K03-B01-M01,1,2,Pf3D7_04_v3,929397,999012,69615
SMI028-K03-B01-M01,1,2,Pf3D7_05_v3,62996,92221,29225
SMI028-K03-B01-M01,1,2,Pf3D7_05_v3,110728,288859,178131
SMI028-K03-B01-M01,1,2,Pf3D7_06_v3,635935,1294070,658135
SMI028-K03-B01-M01,1,2,Pf3D7_07_v3,77194,619398,542204
SMI028-K03-B01-M01,1,2,Pf3D7_07_v3,619957,1380526,760569
SMI028-K03-B01-M01,1,2,Pf3D7_08_v3,75691,1278610,1202919
SMI028-K03-B01-M01,1,2,Pf3D7_11_v3,683965,1637389,953424
SMI028-K03-B01-M01,1,2,Pf3D7_12_v3,382400,1670700,1288300
SMI028-K03-B01-M01,1,2,Pf3D7_13_v3,863568,2788579,1925011
SMI028-K03-B01-M01,1,2,Pf3D7_14_v3,35796,3255607,3219811
SMI029-K03-B01-M01,0,1,Pf3D7_01_v3,487895,567657,79762
SMI029-K03-B01-M01,0,1,Pf3D7_02_v3,109248,805840,696592
SMI029-K03-B01-M01,0,1,Pf3D7_03_v3,827914,1002946,175032
SMI029-K03-B01-M01,0,1,Pf3D7_04_v3,91817,991328,899511
SMI029-K03-B01-M01,0,1,Pf3D7_05_v3,224735,404998,180263
SMI029-K03-B01-M01,0,1,Pf3D7_05_v3,673393,1038517,365124
SMI029-K03-B01-M01,0,1,Pf3D7_06_v3,551853,1266600,714747
SMI029-K03-B01-M01,0,1,Pf3D7_07_v3,619957,1171997,552040
SMI029-K03-B01-M01,0,1,Pf3D7_08_v3,486805,919126,432321
SMI029-K03-B01-M01,0,1,Pf3D7_08_v3,1278610,1326111,47501
SMI029-K03-B01-M01,0,1,Pf3D7_09_v3,158439,271024,112585
SMI029-K03-B01-M01,0,1,Pf3D7_09_v3,283356,500646,217290
SMI029-K03-B01-M01,0,1,Pf3D7_10_v3,1254230,1570149,315919
SMI029-K03-B01-M01,0,1,Pf3D7_11_v3,110641,473241,362600
SMI029-K03-B01-M01,0,1,Pf3D7_11_v3,1006396,1294584,288188
SMI029-K03-B01-M01,0,1,Pf3D7_12_v3,839293,1670700,831407
SMI029-K03-B01-M01,0,1,Pf3D7_13_v3,2548295,2575636,27341
SMI029-K03-B01-M01,0,1,Pf3D7_14_v3,407383,918720,511337
SMI029-K03-B01-M01,0,1,Pf3D7_14_v3,2035328,2231863,196535
SMI029-K03-B01-M01,0,1,Pf3D7_14_v3,3126153,3255607,129454
SMI029-K03-B01-M01,0,2,Pf3D7_02_v3,805840,862030,56190
SMI029-K03-B01-M01,0,2,Pf3D7_03_v3,71040,183105,112065
SMI029-K03-B01-M01,0,2,Pf3D7_03_v3,260247,827914,567667
SMI029-K03-B01-M01,0,2,Pf3D7_05_v3,404998,507871,102873
SMI029-K03-B01-M01,0,2,Pf3D7_06_v3,1266600,1294070,27470
SMI029-K03-B01-M01,0,2,Pf3D7_07_v3,77194,619957,542763
SMI029-K03-B01-M01,0,2,Pf3D7_09_v3,271024,283356,12332
SMI029-K03-B01-M01,0,2,Pf3D7_11_v3,473241,683965,210724
SMI029-K03-B01-M01,0,2,Pf3D7_11_v3,1543806,2003008,459202
SMI029-K03-B01-M01,0,2,Pf3D7_12_v3,61435,382400,320965
SMI029-K03-B01-M01,0,2,Pf3D7_14_v3,918720,2035328,1116608
SMI029-K03-B01-M01,0,2,Pf3D7_14_v3,2231863,3126153,894290
SMI029-K03-B01-M01,1,2,Pf3D7_01_v3,95518,487895,392377
SMI029-K03-B01-M01,1,2,Pf3D7_03_v3,183105,260247,77142
SMI029-K03-B01-M01,1,2,Pf3D7_04_v3,991328,1143965,152637
SMI029-K03-B01-M01,1,2,Pf3D7_05_v3,39872,224735,184863
SMI029-K03-B01-M01,1,2,Pf3D7_05_v3,507871,673393,165522
SMI029-K03-B01-M01,1,2,Pf3D7_05_v3,1038517,1321074,282557
SMI029-K03-B01-M01,1,2,Pf3D7_06_v3,74373,551853,477480
SMI029-K03-B01-M01,1,2,Pf3D7_07_v3,1171997,1380526,208529
SMI029-K03-B01-M01,1,2,Pf3D7_08_v3,75691,486805,411114
SMI029-K03-B01-M01,1,2,Pf3D7_08_v3,919126,1278610,359484
SMI029-K03-B01-M01,1,2,Pf3D7_08_v3,1326111,1364499,38388
SMI029-K03-B01-M01,1,2,Pf3D7_09_v3,82153,158439,76286
SMI029-K03-B01-M01,1,2,Pf3D7_09_v3,500646,1472334,971688
SMI029-K03-B01-M01,1,2,Pf3D7_10_v3,70764,1254230,1183466
SMI029-K03-B01-M01,1,2,Pf3D7_11_v3,683965,1006396,322431
SMI029-K03-B01-M01,1,2,Pf3D7_11_v3,1294584,1543806,249222
SMI029-K03-B01-M01,1,2,Pf3D7_12_v3,382400,839293,456893
SMI029-K03-B01-M01,1,2,Pf3D7_12_v3,1670700,2155095,484395
SMI029-K03-B01-M01,1,2,Pf3D7_13_v3,77901,2548295,2470394
SMI029-K03-B01-M01,1,2,Pf3D7_13_v3,2575636,2788579,212943
SMI029-K03-B01-M01,1,2,Pf3D7_14_v3,35796,407383,371587
SMI031-K03-B01-M02,0,1,Pf3D7_01_v3,95518,528425,432907
SMI031-K03-B01-M02,0,1,Pf3D7_02_v3,805840,862030,56190
SMI031-K03-B01-M02,0,1,Pf3D7_03_v3,71040,1002946,931906
SMI031-K03-B01-M02,0,1,Pf3D7_04_v3,91817,255939,164122
SMI031-K03-B01-M02,0,1,Pf3D7_04_v3,999012,1143965,144953
SMI031-K03-B01-M02,0,1,Pf3D7_05_v3,39872,1321074,1281202
SMI031-K03-B01-M02,0,1,Pf3D7_06_v3,74373,1111651,1037278
SMI031-K03-B01-M02,0,1,Pf3D7_07_v3,249374,619957,370583
SMI031-K03-B01-M02,0,1,Pf3D7_07_v3,1159773,1380526,220753
SMI031-K03-B01-M02,0,1,Pf3D7_08_v3,75691,426411,350720
SMI031-K03-B01-M02,0,1,Pf3D7_08_v3,1102513,1364499,261986
SMI031-K03-B01-M02,0,1,Pf3D7_09_v3,82153,1468673,1386520
SMI031-K03-B01-M02,0,1,Pf3D7_10_v3,222495,1570149,1347654
SMI031-K03-B01-M02,0,1,Pf3D7_11_v3,110641,2003008,1892367
SMI031-K03-B01-M02,0,1,Pf3D7_12_v3,61435,382400,320965
SMI031-K03-B01-M02,0,1,Pf3D7_12_v3,907264,1670700,763436
SMI031-K03-B01-M02,0,1,Pf3D7_13_v3,1244791,2575636,1330845
SMI031-K03-B01-M02,0,1,Pf3D7_14_v3,337415,624348,286933
SMI031-K03-B01-M02,0,1,Pf3D7_14_v3,918720,2753325,1834605
SMI031-K03-B01-M02,0,1,Pf3D7_14_v3,3084224,3193558,109334
SMI031-K03-B01-M02,0,2,Pf3D7_01_v3,95518,528425,432907
SMI031-K03-B01-M02,0,2,Pf3D7_02_v3,805840,862030,56190
SMI031-K03-B01-M02,0,2,Pf3D7_03_v3,71040,1002946,931906
SMI031-K03-B01-M02,0,2,Pf3D7_04_v3,91817,255939,164122
SMI031-K03-B01-M02,0,2,Pf3D7_04_v3,999012,1143965,144953
SMI031-K03-B01-M02,0,2,Pf3D7_05_v3,39872,1321074,1281202
SMI031-K03-B01-M02,0,2,Pf3D7_06_v3,74373,1111651,1037278
SMI031-K03-B01-M02,0,2,Pf3D7_07_v3,249374,619957,370583
SMI031-K03-B01-M02,0,2,Pf3D7_07_v3,1159773,1380526,220753
SMI031-K03-B01-M02,0,2,Pf3D7_08_v3,75691,426411,350720
SMI031-K03-B01-M02,0,2,Pf3D7_08_v3,1102513,1364499,261986
SMI031-K03-B01-M02,0,2,Pf3D7_09_v3,82153,1468673,1386520
SMI031-K03-B01-M02,0,2,Pf3D7_10_v3,222495,1570149,1347654
SMI031-K03-B01-M02,0,2,Pf3D7_11_v3,110641,2003008,1892367
SMI031-K03-B01-M02,0,2,Pf3D7_12_v3,61435,382400,320965
SMI031-K03-B01-M02,0,2,Pf3D7_12_v3,907264,1670700,763436
SMI031-K03-B01-M02,0,2,Pf3D7_13_v3,1244791,2575636,1330845
SMI031-K03-B01-M02,0,2,Pf3D7_14_v3,337415,624348,286933
SMI031-K03-B01-M02,0,2,Pf3D7_14_v3,918720,2753325,1834605
SMI031-K03-B01-M02,0,2,Pf3D7_14_v3,3084224,3193558,109334
SMI031-K03-B01-M02,1,2,Pf3D7_01_v3,95518,567657,472139
SMI031-K03-B01-M02,1,2,Pf3D7_02_v3,109248,862030,752782
SMI031-K03-B01-M02,1,2,Pf3D7_03_v3,71040,1002946,931906
SMI031-K03-B01-M02,1,2,Pf3D7_04_v3,91817,1143965,1052148
SMI031-K03-B01-M02,1,2,Pf3D7_05_v3,39872,1321074,1281202
SMI031-K03-B01-M02,1,2,Pf3D7_06_v3,74373,1294070,1219697
SMI031-K03-B01-M02,1,2,Pf3D7_07_v3,77194,1380526,1303332
SMI031-K03-B01-M02,1,2,Pf3D7_08_v3,75691,1364499,1288808
SMI031-K03-B01-M02,1,2,Pf3D7_09_v3,82153,1472334,1390181
SMI031-K03-B01-M02,1,2,Pf3D7_10_v3,70764,1570149,1499385
SMI031-K03-B01-M02,1,2,Pf3D7_11_v3,110641,2003008,1892367
SMI031-K03-B01-M02,1,2,Pf3D7_12_v3,61435,2155095,2093660
SMI031-K03-B01-M02,1,2,Pf3D7_13_v3,77901,2788579,2710678
SMI031-K03-B01-M02,1,2,Pf3D7_14_v3,35796,3255607,3219811
SMI032-K03-B02-M03,0,1,Pf3D7_01_v3,180309,567657,387348
SMI032-K03-B02-M03,0,1,Pf3D7_02_v3,109248,297229,187981
SMI032-K03-B02-M03,0,1,Pf3D7_02_v3,375825,438700,62875
SMI032-K03-B02-M03,0,1,Pf3D7_02_v3,468251,846247,377996
SMI032-K03-B02-M03,0,1,Pf3D7_03_v3,511284,878750,367466
SMI032-K03-B02-M03,0,1,Pf3D7_03_v3,942805,1002946,60141
SMI032-K03-B02-M03,0,1,Pf3D7_04_v3,91817,731095,639278
SMI032-K03-B02-M03,0,1,Pf3D7_04_v3,766775,1143965,377190
SMI032-K03-B02-M03,0,1,Pf3D7_05_v3,39872,1321074,1281202
SMI032-K03-B02-M03,0,1,Pf3D7_06_v3,74373,159992,85619
SMI032-K03-B02-M03,0,1,Pf3D7_06_v3,345979,1111651,765672
SMI032-K03-B02-M03,0,1,Pf3D7_06_v3,1283406,1294070,10664
SMI032-K03-B02-M03,0,1,Pf3D7_07_v3,77194,1380526,1303332
SMI032-K03-B02-M03,0,1,Pf3D7_08_v3,75691,1364499,1288808
SMI032-K03-B02-M03,0,1,Pf3D7_09_v3,82153,833139,750986
SMI032-K03-B02-M03,0,1,Pf3D7_10_v3,693990,1244491,550501
SMI032-K03-B02-M03,0,1,Pf3D7_10_v3,1254230,1432783,178553
SMI032-K03-B02-M03,0,1,Pf3D7_11_v3,154299,1084422,930123
SMI032-K03-B02-M03,0,1,Pf3D7_11_v3,1294753,1295066,313
SMI032-K03-B02-M03,0,1,Pf3D7_12_v3,122749,382400,259651
SMI032-K03-B02-M03,0,1,Pf3D7_12_v3,739074,1661755,922681
SMI032-K03-B02-M03,0,1,Pf3D7_12_v3,1670700,2081873,411173
SMI032-K03-B02-M03,0,1,Pf3D7_13_v3,106161,531261,425100
SMI032-K03-B02-M03,0,1,Pf3D7_13_v3,792970,2788579,1995609
SMI032-K03-B02-M03,0,1,Pf3D7_14_v3,35796,1036865,1001069
SMI032-K03-B02-M03,0,1,Pf3D7_14_v3,1151944,1209838,57894
SMI032-K03-B02-M03,0,1,Pf3D7_14_v3,1267875,1819017,551142
SMI032-K03-B02-M03,0,1,Pf3D7_14_v3,1992294,2020660,28366
SMI032-K03-B02-M03,0,1,Pf3D7_14_v3,3014048,3255607,241559
SMI033-K03-B02-M02,0,1,Pf3D7_01_v3,95518,567657,472139
SMI033-K03-B02-M02,0,1,Pf3D7_02_v3,109248,253753,144505
SMI033-K03-B02-M02,0,1,Pf3D7_02_v3,438700,862030,423330
SMI033-K03-B02-M02,0,1,Pf3D7_03_v3,71040,878750,807710
SMI033-K03-B02-M02,0,1,Pf3D7_04_v3,255939,1030870,774931
SMI033-K03-B02-M02,0,1,Pf3D7_05_v3,269653,678963,409310
SMI033-K03-B02-M02,0,1,Pf3D7_05_v3,1038517,1043303,4786
SMI033-K03-B02-M02,0,1,Pf3D7_05_v3,1204155,1321074,116919
SMI033-K03-B02-M02,0,1,Pf3D7_06_v3,74373,1294070,1219697
SMI033-K03-B02-M02,0,1,Pf3D7_07_v3,77194,1193645,1116451
SMI033-K03-B02-M02,0,1,Pf3D7_08_v3,119204,1084240,965036
SMI033-K03-B02-M02,0,1,Pf3D7_08_v3,1113495,1364499,251004
SMI033-K03-B02-M02,0,1,Pf3D7_09_v3,82153,1472334,1390181
SMI033-K03-B02-M02,0,1,Pf3D7_10_v3,70764,1570149,1499385
SMI033-K03-B02-M02,0,1,Pf3D7_11_v3,110641,473241,362600
SMI033-K03-B02-M02,0,1,Pf3D7_11_v3,792550,2003008,1210458
SMI033-K03-B02-M02,0,1,Pf3D7_12_v3,61435,1661755,1600320
SMI033-K03-B02-M02,0,1,Pf3D7_12_v3,1670700,2155095,484395
SMI033-K03-B02-M02,0,1,Pf3D7_13_v3,77901,106070,28169
SMI033-K03-B02-M02,0,1,Pf3D7_13_v3,106161,2575636,2469475
SMI033-K03-B02-M02,0,1,Pf3D7_13_v3,2735643,2788579,52936
SMI033-K03-B02-M02,0,1,Pf3D7_14_v3,35796,851498,815702
SMI033-K03-B02-M02,0,1,Pf3D7_14_v3,918720,3255607,2336887
SMI034-K03-B01-M03,0,1,Pf3D7_01_v3,95518,567657,472139
SMI034-K03-B01-M03,0,1,Pf3D7_02_v3,109248,605425,496177
SMI034-K03-B01-M03,0,1,Pf3D7_02_v3,805840,862030,56190
SMI034-K03-B01-M03,0,1,Pf3D7_03_v3,71040,108315,37275
SMI034-K03-B01-M03,0,1,Pf3D7_03_v3,273124,1002946,729822
SMI034-K03-B01-M03,0,1,Pf3D7_04_v3,91817,311508,219691
SMI034-K03-B01-M03,0,1,Pf3D7_04_v3,444247,544673,100426
SMI034-K03-B01-M03,0,1,Pf3D7_04_v3,625475,1035496,410021
SMI034-K03-B01-M03,0,1,Pf3D7_04_v3,1036984,1101849,64865
SMI034-K03-B01-M03,0,1,Pf3D7_05_v3,383150,1192330,809180
SMI034-K03-B01-M03,0,1,Pf3D7_05_v3,1204155,1321074,116919
SMI034-K03-B01-M03,0,1,Pf3D7_06_v3,74373,272719,198346
SMI034-K03-B01-M03,0,1,Pf3D7_06_v3,636044,796597,160553
SMI034-K03-B01-M03,0,1,Pf3D7_06_v3,1111651,1261391,149740
SMI034-K03-B01-M03,0,1,Pf3D7_07_v3,157969,449987,292018
SMI034-K03-B01-M03,0,1,Pf3D7_07_v3,468876,480458,11582
SMI034-K03-B01-M03,0,1,Pf3D7_08_v3,328054,486805,158751
SMI034-K03-B01-M03,0,1,Pf3D7_08_v3,1169948,1278610,108662
SMI034-K03-B01-M03,0,1,Pf3D7_08_v3,1360603,1364499,3896
SMI034-K03-B01-M03,0,1,Pf3D7_09_v3,82153,1472334,1390181
SMI034-K03-B01-M03,0,1,Pf3D7_10_v3,70764,222264,151500
SMI034-K03-B01-M03,0,1,Pf3D7_10_v3,399698,455427,55729
SMI034-K03-B01-M03,0,1,Pf3D7_10_v3,1124529,1326050,201521
SMI034-K03-B01-M03,0,1,Pf3D7_10_v3,1326390,1570149,243759
SMI034-K03-B01-M03,0,1,Pf3D7_11_v3,110641,385357,274716
SMI034-K03-B01-M03,0,1,Pf3D7_11_v3,1084422,2003008,918586
SMI034-K03-B01-M03,0,1,Pf3D7_12_v3,61435,2155095,2093660
SMI034-K03-B01-M03,0,1,Pf3D7_13_v3,77901,277957,200056
SMI034-K03-B01-M03,0,1,Pf3D7_13_v3,403839,531261,127422
SMI034-K03-B01-M03,0,1,Pf3D7_13_v3,1265571,1276301,10730
SMI034-K03-B01-M03,0,1,Pf3D7_13_v3,1891015,2642167,751152
SMI034-K03-B01-M03,0,1,Pf3D7_14_v3,39477,150273,110796
SMI034-K03-B01-M03,0,1,Pf3D7_14_v3,675798,918720,242922
SMI034-K03-B01-M03,0,1,Pf3D7_14_v3,1367225,1367722,497
SMI034-K03-B01-M03,0,1,Pf3D7_14_v3,1656678,1710120,53442
SMI034-K03-B01-M03,0,1,Pf3D7_14_v3,1757603,2006084,248481
SMI034-K03-B01-M03,0,1,Pf3D7_14_v3,2451029,3255607,804578
SMI034-K03-B01-M03,0,2,Pf3D7_01_v3,95518,567657,472139
SMI034-K03-B01-M03,0,2,Pf3D7_02_v3,109248,605425,496177
SMI034-K03-B01-M03,0,2,Pf3D7_02_v3,805840,862030,56190
SMI034-K03-B01-M03,0,2,Pf3D7_03_v3,71040,108315,37275
SMI034-K03-B01-M03,0,2,Pf3D7_03_v3,273124,1002946,729822
SMI034-K03-B01-M03,0,2,Pf3D7_04_v3,91817,311508,219691
SMI034-K03-B01-M03,0,2,Pf3D7_04_v3,444247,544673,100426
SMI034-K03-B01-M03,0,2,Pf3D7_04_v3,625475,1035496,410021
SMI034-K03-B01-M03,0,2,Pf3D7_04_v3,1036984,1101849,64865
SMI034-K03-B01-M03,0,2,Pf3D7_05_v3,383150,1192330,809180
SMI034-K03-B01-M03,0,2,Pf3D7_05_v3,1204155,1321074,116919
SMI034-K03-B01-M03,0,2,Pf3D7_06_v3,74373,272719,198346
SMI034-K03-B01-M03,0,2,Pf3D7_06_v3,636044,796597,160553
SMI034-K03-B01-M03,0,2,Pf3D7_06_v3,1111651,1261391,149740
SMI034-K03-B01-M03,0,2,Pf3D7_07_v3,157969,449987,292018
SMI034-K03-B01-M03,0,2,Pf3D7_07_v3,468876,480458,11582
SMI034-K03-B01-M03,0,2,Pf3D7_08_v3,328054,486805,158751
SMI034-K03-B01-M03,0,2,Pf3D7_08_v3,1169948,1278610,108662
SMI034-K03-B01-M03,0,2,Pf3D7_08_v3,1360603,1364499,3896
SMI034-K03-B01-M03,0,2,Pf3D7_09_v3,82153,1472334,1390181
SMI034-K03-B01-M03,0,2,Pf3D7_10_v3,70764,222264,151500
SMI034-K03-B01-M03,0,2,Pf3D7_10_v3,399698,455427,55729
SMI034-K03-B01-M03,0,2,Pf3D7_10_v3,1124529,1326050,201521
SMI034-K03-B01-M03,0,2,Pf3D7_10_v3,1326390,1570149,243759
SMI034-K03-B01-M03,0,2,Pf3D7_11_v3,110641,385357,274716
SMI034-K03-B01-M03,0,2,Pf3D7_11_v3,1084422,2003008,918586
SMI034-K03-B01-M03,0,2,Pf3D7_12_v3,61435,2155095,2093660
SMI034-K03-B01-M03,0,2,Pf3D7_13_v3,77901,277957,200056
SMI034-K03-B01-M03,0,2,Pf3D7_13_v3,403839,531261,127422
SMI034-K03-B01-M03,0,2,Pf3D7_13_v3,1265571,1276301,10730
SMI034-K03-B01-M03,0,2,Pf3D7_13_v3,1891015,2642167,751152
SMI034-K03-B01-M03,0,2,Pf3D7_14_v3,39477,150273,110796
SMI034-K03-B01-M03,0,2,Pf3D7_14_v3,675798,918720,242922
SMI034-K03-B01-M03,0,2,Pf3D7_14_v3,1367225,1367722,497
SMI034-K03-B01-M03,0,2,Pf3D7_14_v3,1656678,1710120,53442
SMI034-K03-B01-M03,0,2,Pf3D7_14_v3,1757603,2006084,248481
SMI034-K03-B01-M03,0,2,Pf3D7_14_v3,2451029,3255607,804578
SMI034-K03-B01-M03,1,2,Pf3D7_01_v3,95518,567657,472139
SMI034-K03-B01-M03,1,2,Pf3D7_02_v3,109248,862030,752782
SMI034-K03-B01-M03,1,2,Pf3D7_03_v3,71040,1002946,931906
SMI034-K03-B01-M03,1,2,Pf3D7_04_v3,91817,1143965,1052148
SMI034-K03-B01-M03,1,2,Pf3D7_05_v3,39872,1321074,1281202
SMI034-K03-B01-M03,1,2,Pf3D7_06_v3,74373,1294070,1219697
SMI034-K03-B01-M03,1,2,Pf3D7_07_v3,77194,1380526,1303332
SMI034-K03-B01-M03,1,2,Pf3D7_08_v3,75691,1364499,1288808
SMI034-K03-B01-M03,1,2,Pf3D7_09_v3,82153,1472334,1390181
SMI034-K03-B01-M03,1,2,Pf3D7_10_v3,70764,1570149,1499385
SMI034-K03-B01-M03,1,2,Pf3D7_11_v3,110641,2003008,1892367
SMI034-K03-B01-M03,1,2,Pf3D7_12_v3,61435,2155095,2093660
SMI034-K03-B01-M03,1,2,Pf3D7_13_v3,77901,2788579,2710678
SMI034-K03-B01-M03,1,2,Pf3D7_14_v3,35796,3255607,3219811
SMI035-K03-B01-M01,0,1,Pf3D7_01_v3,527341,532921,5580
SMI035-K03-B01-M01,0,1,Pf3D7_02_v3,805840,862030,56190
SMI035-K03-B01-M01,0,1,Pf3D7_03_v3,71040,1002946,931906
SMI035-K03-B01-M01,0,1,Pf3D7_04_v3,91817,159572,67755
SMI035-K03-B01-M01,0,1,Pf3D7_04_v3,255939,485881,229942
SMI035-K03-B01-M01,0,1,Pf3D7_04_v3,512825,695081,182256
SMI035-K03-B01-M01,0,1,Pf3D7_04_v3,1111429,1143965,32536
SMI035-K03-B01-M01,0,1,Pf3D7_05_v3,39872,62996,23124
SMI035-K03-B01-M01,0,1,Pf3D7_05_v3,131301,615300,483999
SMI035-K03-B01-M01,0,1,Pf3D7_05_v3,1038517,1263168,224651
SMI035-K03-B01-M01,0,1,Pf3D7_06_v3,1269645,1294070,24425
SMI035-K03-B01-M01,0,1,Pf3D7_07_v3,77194,1380526,1303332
SMI035-K03-B01-M01,0,1,Pf3D7_08_v3,75691,102094,26403
SMI035-K03-B01-M01,0,1,Pf3D7_08_v3,619138,812418,193280
SMI035-K03-B01-M01,0,1,Pf3D7_09_v3,1415251,1468670,53419
SMI035-K03-B01-M01,0,1,Pf3D7_11_v3,435509,942790,507281
SMI035-K03-B01-M01,0,1,Pf3D7_11_v3,1294584,1294741,157
SMI035-K03-B01-M01,0,1,Pf3D7_11_v3,1686825,2003008,316183
SMI035-K03-B01-M01,0,1,Pf3D7_12_v3,61435,95067,33632
SMI035-K03-B01-M01,0,1,Pf3D7_12_v3,382400,727996,345596
SMI035-K03-B01-M01,0,1,Pf3D7_13_v3,2575636,2788579,212943
SMI035-K03-B01-M01,0,1,Pf3D7_14_v3,35796,907527,871731
SMI035-K03-B01-M01,0,1,Pf3D7_14_v3,3179803,3255607,75804
SMI035-K03-B01-M01,0,2,Pf3D7_01_v3,164024,527341,363317
SMI035-K03-B01-M01,0,2,Pf3D7_04_v3,159572,255939,96367
SMI035-K03-B01-M01,0,2,Pf3D7_04_v3,485883,512825,26942
SMI035-K03-B01-M01,0,2,Pf3D7_04_v3,865912,999012,133100
SMI035-K03-B01-M01,0,2,Pf3D7_05_v3,1263168,1321074,57906
SMI035-K03-B01-M01,0,2,Pf3D7_06_v3,74373,532206,457833
SMI035-K03-B01-M01,0,2,Pf3D7_06_v3,1111651,1269645,157994
SMI035-K03-B01-M01,0,2,Pf3D7_08_v3,102094,619138,517044
SMI035-K03-B01-M01,0,2,Pf3D7_08_v3,812418,1056711,244293
SMI035-K03-B01-M01,0,2,Pf3D7_08_v3,1278610,1314033,35423
SMI035-K03-B01-M01,0,2,Pf3D7_09_v3,1468670,1472334,3664
SMI035-K03-B01-M01,0,2,Pf3D7_10_v3,70764,1254230,1183466
SMI035-K03-B01-M01,0,2,Pf3D7_11_v3,942790,1294584,351794
SMI035-K03-B01-M01,0,2,Pf3D7_12_v3,1670700,2155095,484395
SMI035-K03-B01-M01,0,2,Pf3D7_13_v3,1960122,2575636,615514
SMI035-K03-B01-M01,0,2,Pf3D7_14_v3,907527,1473534,566007
SMI035-K03-B01-M01,1,2,Pf3D7_01_v3,95518,164024,68506
SMI035-K03-B01-M01,1,2,Pf3D7_01_v3,532921,567657,34736
SMI035-K03-B01-M01,1,2,Pf3D7_02_v3,109248,805840,696592
SMI035-K03-B01-M01,1,2,Pf3D7_04_v3,485881,485883,2
SMI035-K03-B01-M01,1,2,Pf3D7_04_v3,695081,865912,170831
SMI035-K03-B01-M01,1,2,Pf3D7_04_v3,999012,1111429,112417
SMI035-K03-B01-M01,1,2,Pf3D7_05_v3,62996,131301,68305
SMI035-K03-B01-M01,1,2,Pf3D7_05_v3,615300,1038517,423217
SMI035-K03-B01-M01,1,2,Pf3D7_06_v3,532206,1111651,579445
SMI035-K03-B01-M01,1,2,Pf3D7_08_v3,1056711,1278610,221899
SMI035-K03-B01-M01,1,2,Pf3D7_08_v3,1314033,1364499,50466
SMI035-K03-B01-M01,1,2,Pf3D7_09_v3,82153,1415251,1333098
SMI035-K03-B01-M01,1,2,Pf3D7_10_v3,1254230,1570149,315919
SMI035-K03-B01-M01,1,2,Pf3D7_11_v3,110641,435509,324868
SMI035-K03-B01-M01,1,2,Pf3D7_11_v3,1294741,1686825,392084
SMI035-K03-B01-M01,1,2,Pf3D7_12_v3,95067,382400,287333
SMI035-K03-B01-M01,1,2,Pf3D7_12_v3,727996,1670700,942704
SMI035-K03-B01-M01,1,2,Pf3D7_13_v3,77901,1960122,1882221
SMI035-K03-B01-M01,1,2,Pf3D7_14_v3,1473534,3179803,1706269
SMI036-K03-B01-M03,0,1,Pf3D7_01_v3,95518,290195,194677
SMI036-K03-B01-M03,0,1,Pf3D7_02_v3,310824,805840,495016
SMI036-K03-B01-M03,0,1,Pf3D7_02_v3,836358,862030,25672
SMI036-K03-B01-M03,0,1,Pf3D7_03_v3,71040,878750,807710
SMI036-K03-B01-M03,0,1,Pf3D7_04_v3,255939,528936,272997
SMI036-K03-B01-M03,0,1,Pf3D7_04_v3,692160,770292,78132
SMI036-K03-B01-M03,0,1,Pf3D7_04_v3,1032241,1143965,111724
SMI036-K03-B01-M03,0,1,Pf3D7_05_v3,39872,615926,576054
SMI036-K03-B01-M03,0,1,Pf3D7_05_v3,951120,1321074,369954
SMI036-K03-B01-M03,0,1,Pf3D7_06_v3,74373,1294070,1219697
SMI036-K03-B01-M03,0,1,Pf3D7_07_v3,77194,376423,299229
SMI036-K03-B01-M03,0,1,Pf3D7_07_v3,454103,460942,6839
SMI036-K03-B01-M03,0,1,Pf3D7_07_v3,480458,635759,155301
SMI036-K03-B01-M03,0,1,Pf3D7_07_v3,1234265,1380526,146261
SMI036-K03-B01-M03,0,1,Pf3D7_08_v3,75691,826695,751004
SMI036-K03-B01-M03,0,1,Pf3D7_08_v3,1113495,1364499,251004
SMI036-K03-B01-M03,0,1,Pf3D7_09_v3,82153,500646,418493
SMI036-K03-B01-M03,0,1,Pf3D7_09_v3,686984,1472334,785350
SMI036-K03-B01-M03,0,1,Pf3D7_10_v3,70764,694250,623486
SMI036-K03-B01-M03,0,1,Pf3D7_10_v3,1189293,1432783,243490
SMI036-K03-B01-M03,0,1,Pf3D7_11_v3,354205,2003008,1648803
SMI036-K03-B01-M03,0,1,Pf3D7_12_v3,61435,454890,393455
SMI036-K03-B01-M03,0,1,Pf3D7_12_v3,947534,2155095,1207561
SMI036-K03-B01-M03,0,1,Pf3D7_13_v3,77901,939344,861443
SMI036-K03-B01-M03,0,1,Pf3D7_13_v3,986875,2788579,1801704
SMI036-K03-B01-M03,0,1,Pf3D7_14_v3,35796,699548,663752
SMI036-K03-B01-M03,0,1,Pf3D7_14_v3,918720,3121099,2202379
SMI036-K03-B01-M03,0,1,Pf3D7_14_v3,3214367,3255607,41240
SMI036-K03-B01-M03,0,2,Pf3D7_01_v3,190739,487895,297156
SMI036-K03-B01-M03,0,2,Pf3D7_02_v3,310824,862030,551206
SMI036-K03-B01-M03,0,2,Pf3D7_03_v3,71040,1002946,931906
SMI036-K03-B01-M03,0,2,Pf3D7_04_v3,91817,528936,437119
SMI036-K03-B01-M03,0,2,Pf3D7_04_v3,692160,770292,78132
SMI036-K03-B01-M03,0,2,Pf3D7_04_v3,830755,1143965,313210
SMI036-K03-B01-M03,0,2,Pf3D7_05_v3,39872,615926,576054
SMI036-K03-B01-M03,0,2,Pf3D7_05_v3,951120,1321074,369954
SMI036-K03-B01-M03,0,2,Pf3D7_06_v3,74373,1294070,1219697
SMI036-K03-B01-M03,0,2,Pf3D7_07_v3,77194,454103,376909
SMI036-K03-B01-M03,0,2,Pf3D7_07_v3,480458,1380526,900068
SMI036-K03-B01-M03,0,2,Pf3D7_08_v3,75691,886458,810767
SMI036-K03-B01-M03,0,2,Pf3D7_08_v3,1099695,1364499,264804
SMI036-K03-B01-M03,0,2,Pf3D7_09_v3,82153,416031,333878
SMI036-K03-B01-M03,0,2,Pf3D7_09_v3,500646,686984,186338
SMI036-K03-B01-M03,0,2,Pf3D7_10_v3,185257,1570149,1384892
SMI036-K03-B01-M03,0,2,Pf3D7_11_v3,110641,354205,243564
SMI036-K03-B01-M03,0,2,Pf3D7_11_v3,778298,1157111,378813
SMI036-K03-B01-M03,0,2,Pf3D7_11_v3,1208199,2003008,794809
SMI036-K03-B01-M03,0,2,Pf3D7_12_v3,61435,454890,393455
SMI036-K03-B01-M03,0,2,Pf3D7_12_v3,852775,947534,94759
SMI036-K03-B01-M03,0,2,Pf3D7_12_v3,1387200,1670700,283500
SMI036-K03-B01-M03,0,2,Pf3D7_12_v3,1680129,2155095,474966
SMI036-K03-B01-M03,0,2,Pf3D7_13_v3,77901,106161,28260
SMI036-K03-B01-M03,0,2,Pf3D7_13_v3,986875,2788579,1801704
SMI036-K03-B01-M03,0,2,Pf3D7_14_v3,35796,2415186,2379390
SMI036-K03-B01-M03,0,2,Pf3D7_14_v3,2451029,3121099,670070
SMI036-K03-B01-M03,0,2,Pf3D7_14_v3,3193462,3214367,20905
SMI036-K03-B01-M03,1,2,Pf3D7_01_v3,190739,290195,99456
SMI036-K03-B01-M03,1,2,Pf3D7_01_v3,487895,567657,79762
SMI036-K03-B01-M03,1,2,Pf3D7_02_v3,109248,805840,696592
SMI036-K03-B01-M03,1,2,Pf3D7_02_v3,836358,862030,25672
SMI036-K03-B01-M03,1,2,Pf3D7_03_v3,71040,878750,807710
SMI036-K03-B01-M03,1,2,Pf3D7_04_v3,255939,830755,574816
SMI036-K03-B01-M03,1,2,Pf3D7_04_v3,1032241,1143965,111724
SMI036-K03-B01-M03,1,2,Pf3D7_05_v3,39872,1321074,1281202
SMI036-K03-B01-M03,1,2,Pf3D7_06_v3,74373,1294070,1219697
SMI036-K03-B01-M03,1,2,Pf3D7_07_v3,77194,376423,299229
SMI036-K03-B01-M03,1,2,Pf3D7_07_v3,460942,635759,174817
SMI036-K03-B01-M03,1,2,Pf3D7_07_v3,1234265,1380526,146261
SMI036-K03-B01-M03,1,2,Pf3D7_08_v3,75691,826695,751004
SMI036-K03-B01-M03,1,2,Pf3D7_08_v3,886458,1099695,213237
SMI036-K03-B01-M03,1,2,Pf3D7_08_v3,1113495,1364499,251004
SMI036-K03-B01-M03,1,2,Pf3D7_09_v3,82153,416031,333878
SMI036-K03-B01-M03,1,2,Pf3D7_10_v3,185257,694250,508993
SMI036-K03-B01-M03,1,2,Pf3D7_10_v3,1189293,1432783,243490
SMI036-K03-B01-M03,1,2,Pf3D7_11_v3,778298,1157111,378813
SMI036-K03-B01-M03,1,2,Pf3D7_11_v3,1208199,2003008,794809
SMI036-K03-B01-M03,1,2,Pf3D7_12_v3,61435,852775,791340
SMI036-K03-B01-M03,1,2,Pf3D7_12_v3,1387200,1670700,283500
SMI036-K03-B01-M03,1,2,Pf3D7_12_v3,1680129,2155095,474966
SMI036-K03-B01-M03,1,2,Pf3D7_13_v3,77901,106161,28260
SMI036-K03-B01-M03,1,2,Pf3D7_13_v3,939344,2788579,1849235
SMI036-K03-B01-M03,1,2,Pf3D7_14_v3,35796,699548,663752
SMI036-K03-B01-M03,1,2,Pf3D7_14_v3,918720,2415186,1496466
SMI036-K03-B01-M03,1,2,Pf3D7_14_v3,2451029,3193462,742433
SMI038-K03-B02-M01,0,1,Pf3D7_01_v3,95518,180068,84550
SMI038-K03-B02-M01,0,1,Pf3D7_02_v3,206291,805840,599549
SMI038-K03-B02-M01,0,1,Pf3D7_04_v3,255939,430540,174601
SMI038-K03-B02-M01,0,1,Pf3D7_04_v3,901096,999012,97916
SMI038-K03-B02-M01,0,1,Pf3D7_04_v3,1055085,1143965,88880
SMI038-K03-B02-M01,0,1,Pf3D7_05_v3,39872,565717,525845
SMI038-K03-B02-M01,0,1,Pf3D7_05_v3,683316,1038517,355201
SMI038-K03-B02-M01,0,1,Pf3D7_06_v3,1288845,1294070,5225
SMI038-K03-B02-M01,0,1,Pf3D7_07_v3,77194,249374,172180
SMI038-K03-B02-M01,0,1,Pf3D7_07_v3,354126,463930,109804
SMI038-K03-B02-M01,0,1,Pf3D7_08_v3,164893,398723,233830
SMI038-K03-B02-M01,0,1,Pf3D7_09_v3,556935,1472334,915399
SMI038-K03-B02-M01,0,1,Pf3D7_10_v3,70764,1570149,1499385
SMI038-K03-B02-M01,0,1,Pf3D7_11_v3,110641,115512,4871
SMI038-K03-B02-M01,0,1,Pf3D7_11_v3,467712,1967527,1499815
SMI038-K03-B02-M01,0,1,Pf3D7_12_v3,1670700,2155095,484395
SMI038-K03-B02-M01,0,1,Pf3D7_13_v3,77901,2179835,2101934
SMI038-K03-B02-M01,0,1,Pf3D7_14_v3,620533,2231863,1611330
SMI038-K03-B02-M01,0,1,Pf3D7_14_v3,3121099,3255607,134508
SMI039-K03-B01-M01,0,1,Pf3D7_02_v3,805840,862030,56190
SMI039-K03-B01-M01,0,1,Pf3D7_03_v3,71040,756863,685823
SMI039-K03-B01-M01,0,1,Pf3D7_05_v3,658627,1042252,383625
SMI039-K03-B01-M01,0,1,Pf3D7_06_v3,304643,532250,227607
SMI039-K03-B01-M01,0,1,Pf3D7_07_v3,782025,1202320,420295
SMI039-K03-B01-M01,0,1,Pf3D7_08_v3,1278610,1325177,46567
SMI039-K03-B01-M01,0,1,Pf3D7_09_v3,182189,202903,20714
SMI039-K03-B01-M01,0,1,Pf3D7_10_v3,270983,1254230,983247
SMI039-K03-B01-M01,0,1,Pf3D7_10_v3,1499415,1570149,70734
SMI039-K03-B01-M01,0,1,Pf3D7_11_v3,110641,1132096,1021455
SMI039-K03-B01-M01,0,1,Pf3D7_13_v3,754525,2575636,1821111
SMI039-K03-B01-M01,0,1,Pf3D7_14_v3,35796,53093,17297
SMI039-K03-B01-M01,0,1,Pf3D7_14_v3,3124670,3255607,130937
SMI039-K03-B01-M01,0,2,Pf3D7_01_v3,145682,567657,421975
SMI039-K03-B01-M01,0,2,Pf3D7_02_v3,109248,805840,696592
SMI039-K03-B01-M01,0,2,Pf3D7_03_v3,756863,1002946,246083
SMI039-K03-B01-M01,0,2,Pf3D7_04_v3,91817,883380,791563
SMI039-K03-B01-M01,0,2,Pf3D7_04_v3,933060,1042880,109820
SMI039-K03-B01-M01,0,2,Pf3D7_05_v3,419891,563411,143520
SMI039-K03-B01-M01,0,2,Pf3D7_05_v3,565717,658627,92910
SMI039-K03-B01-M01,0,2,Pf3D7_05_v3,1042252,1136676,94424
SMI039-K03-B01-M01,0,2,Pf3D7_06_v3,532250,815124,282874
SMI039-K03-B01-M01,0,2,Pf3D7_06_v3,883055,1115191,232136
SMI039-K03-B01-M01,0,2,Pf3D7_07_v3,619957,782025,162068
SMI039-K03-B01-M01,0,2,Pf3D7_07_v3,1202320,1380526,178206
SMI039-K03-B01-M01,0,2,Pf3D7_08_v3,75691,467879,392188
SMI039-K03-B01-M01,0,2,Pf3D7_08_v3,509018,885980,376962
SMI039-K03-B01-M01,0,2,Pf3D7_09_v3,202903,491736,288833
SMI039-K03-B01-M01,0,2,Pf3D7_09_v3,687921,705332,17411
SMI039-K03-B01-M01,0,2,Pf3D7_09_v3,1206885,1472334,265449
SMI039-K03-B01-M01,0,2,Pf3D7_10_v3,70764,270983,200219
SMI039-K03-B01-M01,0,2,Pf3D7_10_v3,1254230,1499415,245185
SMI039-K03-B01-M01,0,2,Pf3D7_11_v3,1385066,2003008,617942
SMI039-K03-B01-M01,0,2,Pf3D7_12_v3,61435,382400,320965
SMI039-K03-B01-M01,0,2,Pf3D7_12_v3,459459,2155095,1695636
SMI039-K03-B01-M01,0,2,Pf3D7_13_v3,77901,754525,676624
SMI039-K03-B01-M01,0,2,Pf3D7_13_v3,2575636,2788579,212943
SMI039-K03-B01-M01,0,2,Pf3D7_14_v3,918720,1393032,474312
SMI039-K03-B01-M01,0,2,Pf3D7_14_v3,2999217,3124670,125453
SMI039-K03-B01-M01,1,2,Pf3D7_01_v3,95518,145682,50164
SMI039-K03-B01-M01,1,2,Pf3D7_04_v3,883380,933060,49680
SMI039-K03-B01-M01,1,2,Pf3D7_04_v3,1042880,1143965,101085
SMI039-K03-B01-M01,1,2,Pf3D7_05_v3,39872,419891,380019
SMI039-K03-B01-M01,1,2,Pf3D7_05_v3,563411,565717,2306
SMI039-K03-B01-M01,1,2,Pf3D7_05_v3,1136676,1321074,184398
SMI039-K03-B01-M01,1,2,Pf3D7_06_v3,74373,304643,230270
SMI039-K03-B01-M01,1,2,Pf3D7_06_v3,815124,883055,67931
SMI039-K03-B01-M01,1,2,Pf3D7_06_v3,1115191,1294070,178879
SMI039-K03-B01-M01,1,2,Pf3D7_07_v3,77194,619957,542763
SMI039-K03-B01-M01,1,2,Pf3D7_08_v3,467879,509018,41139
SMI039-K03-B01-M01,1,2,Pf3D7_08_v3,885980,1278610,392630
SMI039-K03-B01-M01,1,2,Pf3D7_08_v3,1325177,1364499,39322
SMI039-K03-B01-M01,1,2,Pf3D7_09_v3,82153,182189,100036
SMI039-K03-B01-M01,1,2,Pf3D7_09_v3,491736,687921,196185
SMI039-K03-B01-M01,1,2,Pf3D7_09_v3,705332,1206885,501553
SMI039-K03-B01-M01,1,2,Pf3D7_11_v3,1132096,1385066,252970
SMI039-K03-B01-M01,1,2,Pf3D7_12_v3,382400,459459,77059
SMI039-K03-B01-M01,1,2,Pf3D7_14_v3,53093,918720,865627
SMI039-K03-B01-M01,1,2,Pf3D7_14_v3,1393032,2999217,1606185
SMI000-K04-B01-M02,0,1,Pf3D7_01_v3,493159,567657,74498
SMI000-K04-B01-M02,0,1,Pf3D7_02_v3,109248,862030,752782
SMI000-K04-B01-M02,0,1,Pf3D7_03_v3,71040,890218,819178
SMI000-K04-B01-M02,0,1,Pf3D7_04_v3,255939,856599,600660
SMI000-K04-B01-M02,0,1,Pf3D7_04_v3,922780,999012,76232
SMI000-K04-B01-M02,0,1,Pf3D7_05_v3,673560,1038517,364957
SMI000-K04-B01-M02,0,1,Pf3D7_06_v3,1111651,1294070,182419
SMI000-K04-B01-M02,0,1,Pf3D7_07_v3,77194,126292,49098
SMI000-K04-B01-M02,0,1,Pf3D7_07_v3,415137,609762,194625
SMI000-K04-B01-M02,0,1,Pf3D7_07_v3,619957,1109226,489269
SMI000-K04-B01-M02,0,1,Pf3D7_08_v3,1310759,1364499,53740
SMI000-K04-B01-M02,0,1,Pf3D7_09_v3,82153,363301,281148
SMI000-K04-B01-M02,0,1,Pf3D7_09_v3,1080391,1472334,391943
SMI000-K04-B01-M02,0,1,Pf3D7_10_v3,70764,1389266,1318502
SMI000-K04-B01-M02,0,1,Pf3D7_11_v3,787953,2003008,1215055
SMI000-K04-B01-M02,0,1,Pf3D7_12_v3,61435,377095,315660
SMI000-K04-B01-M02,0,1,Pf3D7_12_v3,382400,807679,425279
SMI000-K04-B01-M02,0,1,Pf3D7_13_v3,270924,1682933,1412009
SMI000-K04-B01-M02,0,1,Pf3D7_13_v3,2541529,2788579,247050
SMI000-K04-B01-M02,0,1,Pf3D7_14_v3,35796,312693,276897
SMI000-K04-B01-M02,0,1,Pf3D7_14_v3,420866,602104,181238
SMI000-K04-B01-M02,0,1,Pf3D7_14_v3,918720,1438616,519896
SMI000-K04-B01-M02,0,2,Pf3D7_01_v3,95518,567657,472139
SMI000-K04-B01-M02,0,2,Pf3D7_02_v3,109248,438323,329075
SMI000-K04-B01-M02,0,2,Pf3D7_02_v3,805840,860832,54992
SMI000-K04-B01-M02,0,2,Pf3D7_03_v3,814220,878750,64530
SMI000-K04-B01-M02,0,2,Pf3D7_04_v3,544673,758596,213923
SMI000-K04-B01-M02,0,2,Pf3D7_04_v3,856599,1143965,287366
SMI000-K04-B01-M02,0,2,Pf3D7_05_v3,39872,131301,91429
SMI000-K04-B01-M02,0,2,Pf3D7_05_v3,351970,673560,321590
SMI000-K04-B01-M02,0,2,Pf3D7_05_v3,1038517,1321074,282557
SMI000-K04-B01-M02,0,2,Pf3D7_06_v3,74373,816606,742233
SMI000-K04-B01-M02,0,2,Pf3D7_06_v3,884526,1111651,227125
SMI000-K04-B01-M02,0,2,Pf3D7_07_v3,126292,480458,354166
SMI000-K04-B01-M02,0,2,Pf3D7_07_v3,609762,619957,10195
SMI000-K04-B01-M02,0,2,Pf3D7_07_v3,1109226,1380526,271300
SMI000-K04-B01-M02,0,2,Pf3D7_08_v3,75691,1278610,1202919
SMI000-K04-B01-M02,0,2,Pf3D7_09_v3,929701,994573,64872
SMI000-K04-B01-M02,0,2,Pf3D7_10_v3,1171192,1513542,342350
SMI000-K04-B01-M02,0,2,Pf3D7_11_v3,1294741,2003008,708267
SMI000-K04-B01-M02,0,2,Pf3D7_12_v3,61435,377095,315660
SMI000-K04-B01-M02,0,2,Pf3D7_12_v3,807679,2155095,1347416
SMI000-K04-B01-M02,0,2,Pf3D7_13_v3,77901,270924,193023
SMI000-K04-B01-M02,0,2,Pf3D7_13_v3,1682933,2575636,892703
SMI000-K04-B01-M02,0,2,Pf3D7_14_v3,312693,420866,108173
SMI000-K04-B01-M02,0,2,Pf3D7_14_v3,602104,918720,316616
SMI000-K04-B01-M02,0,2,Pf3D7_14_v3,1438616,3255607,1816991
SMI000-K04-B01-M02,0,3,Pf3D7_01_v3,493159,567657,74498
SMI000-K04-B01-M02,0,3,Pf3D7_02_v3,109248,438323,329075
SMI000-K04-B01-M02,0,3,Pf3D7_02_v3,805840,860832,54992
SMI000-K04-B01-M02,0,3,Pf3D7_03_v3,814220,878750,64530
SMI000-K04-B01-M02,0,3,Pf3D7_03_v3,890218,1002946,112728
SMI000-K04-B01-M02,0,3,Pf3D7_04_v3,91817,255939,164122
SMI000-K04-B01-M02,0,3,Pf3D7_04_v3,544673,758596,213923
SMI000-K04-B01-M02,0,3,Pf3D7_04_v3,922780,999012,76232
SMI000-K04-B01-M02,0,3,Pf3D7_05_v3,131301,351970,220669
SMI000-K04-B01-M02,0,3,Pf3D7_06_v3,816606,884526,67920
SMI000-K04-B01-M02,0,3,Pf3D7_07_v3,415137,480458,65321
SMI000-K04-B01-M02,0,3,Pf3D7_08_v3,1278610,1310759,32149
SMI000-K04-B01-M02,0,3,Pf3D7_09_v3,363301,929701,566400
SMI000-K04-B01-M02,0,3,Pf3D7_09_v3,994573,1080391,85818
SMI000-K04-B01-M02,0,3,Pf3D7_10_v3,1171192,1389266,218074
SMI000-K04-B01-M02,0,3,Pf3D7_10_v3,1513542,1570149,56607
SMI000-K04-B01-M02,0,3,Pf3D7_11_v3,110641,787953,677312
SMI000-K04-B01-M02,0,3,Pf3D7_11_v3,1294741,2003008,708267
SMI000-K04-B01-M02,0,3,Pf3D7_12_v3,61435,382400,320965
SMI000-K04-B01-M02,0,3,Pf3D7_13_v3,2541529,2575636,34107
SMI000-K04-B01-M02,1,2,Pf3D7_01_v3,493159,567657,74498
SMI000-K04-B01-M02,1,2,Pf3D7_02_v3,109248,438323,329075
SMI000-K04-B01-M02,1,2,Pf3D7_02_v3,805840,860832,54992
SMI000-K04-B01-M02,1,2,Pf3D7_03_v3,814220,878750,64530
SMI000-K04-B01-M02,1,2,Pf3D7_03_v3,890218,1002946,112728
SMI000-K04-B01-M02,1,2,Pf3D7_04_v3,91817,255939,164122
SMI000-K04-B01-M02,1,2,Pf3D7_04_v3,544673,758596,213923
SMI000-K04-B01-M02,1,2,Pf3D7_04_v3,922780,999012,76232
SMI000-K04-B01-M02,1,2,Pf3D7_05_v3,131301,351970,220669
SMI000-K04-B01-M02,1,2,Pf3D7_06_v3,816606,884526,67920
SMI000-K04-B01-M02,1,2,Pf3D7_07_v3,415137,480458,65321
SMI000-K04-B01-M02,1,2,Pf3D7_08_v3,1278610,1310759,32149
SMI000-K04-B01-M02,1,2,Pf3D7_09_v3,363301,929701,566400
SMI000-K04-B01-M02,1,2,Pf3D7_09_v3,994573,1080391,85818
SMI000-K04-B01-M02,1,2,Pf3D7_10_v3,1171192,1389266,218074
SMI000-K04-B01-M02,1,2,Pf3D7_10_v3,1513542,1570149,56607
SMI000-K04-B01-M02,1,2,Pf3D7_11_v3,110641,787953,677312
SMI000-K04-B01-M02,1,2,Pf3D7_11_v3,1294741,2003008,708267
SMI000-K04-B01-M02,1,2,Pf3D7_12_v3,61435,382400,320965
SMI000-K04-B01-M02,1,2,Pf3D7_13_v3,2541529,2575636,34107
SMI000-K04-B01-M02,1,3,Pf3D7_01_v3,95518,567657,472139
SMI000-K04-B01-M02,1,3,Pf3D7_02_v3,109248,438323,329075
SMI000-K04-B01-M02,1,3,Pf3D7_02_v3,805840,860832,54992
SMI000-K04-B01-M02,1,3,Pf3D7_03_v3,814220,878750,64530
SMI000-K04-B01-M02,1,3,Pf3D7_04_v3,544673,758596,213923
SMI000-K04-B01-M02,1,3,Pf3D7_04_v3,856599,1143965,287366
SMI000-K04-B01-M02,1,3,Pf3D7_05_v3,39872,131301,91429
SMI000-K04-B01-M02,1,3,Pf3D7_05_v3,351970,673560,321590
SMI000-K04-B01-M02,1,3,Pf3D7_05_v3,1038517,1321074,282557
SMI000-K04-B01-M02,1,3,Pf3D7_06_v3,74373,816606,742233
SMI000-K04-B01-M02,1,3,Pf3D7_06_v3,884526,1111651,227125
SMI000-K04-B01-M02,1,3,Pf3D7_07_v3,126292,480458,354166
SMI000-K04-B01-M02,1,3,Pf3D7_07_v3,609762,619957,10195
SMI000-K04-B01-M02,1,3,Pf3D7_07_v3,1109226,1380526,271300
SMI000-K04-B01-M02,1,3,Pf3D7_08_v3,75691,1278610,1202919
SMI000-K04-B01-M02,1,3,Pf3D7_09_v3,929701,994573,64872
SMI000-K04-B01-M02,1,3,Pf3D7_10_v3,1171192,1513542,342350
SMI000-K04-B01-M02,1,3,Pf3D7_11_v3,1294741,2003008,708267
SMI000-K04-B01-M02,1,3,Pf3D7_12_v3,61435,377095,315660
SMI000-K04-B01-M02,1,3,Pf3D7_12_v3,807679,2155095,1347416
SMI000-K04-B01-M02,1,3,Pf3D7_13_v3,77901,270924,193023
SMI000-K04-B01-M02,1,3,Pf3D7_13_v3,1682933,2575636,892703
SMI000-K04-B01-M02,1,3,Pf3D7_14_v3,312693,420866,108173
SMI000-K04-B01-M02,1,3,Pf3D7_14_v3,602104,918720,316616
SMI000-K04-B01-M02,1,3,Pf3D7_14_v3,1438616,3255607,1816991
SMI000-K04-B01-M02,2,3,Pf3D7_01_v3,493159,567657,74498
SMI000-K04-B01-M02,2,3,Pf3D7_02_v3,109248,862030,752782
SMI000-K04-B01-M02,2,3,Pf3D7_03_v3,71040,890218,819178
SMI000-K04-B01-M02,2,3,Pf3D7_04_v3,255939,856599,600660
SMI000-K04-B01-M02,2,3,Pf3D7_04_v3,922780,999012,76232
SMI000-K04-B01-M02,2,3,Pf3D7_05_v3,673560,1038517,364957
SMI000-K04-B01-M02,2,3,Pf3D7_06_v3,1111651,1294070,182419
SMI000-K04-B01-M02,2,3,Pf3D7_07_v3,77194,126292,49098
SMI000-K04-B01-M02,2,3,Pf3D7_07_v3,415137,609762,194625
SMI000-K04-B01-M02,2,3,Pf3D7_07_v3,619957,1109226,489269
SMI000-K04-B01-M02,2,3,Pf3D7_08_v3,1310759,1364499,53740
SMI000-K04-B01-M02,2,3,Pf3D7_09_v3,82153,363301,281148
SMI000-K04-B01-M02,2,3,Pf3D7_09_v3,1080391,1472334,391943
SMI000-K04-B01-M02,2,3,Pf3D7_10_v3,70764,1389266,1318502
SMI000-K04-B01-M02,2,3,Pf3D7_11_v3,787953,2003008,1215055
SMI000-K04-B01-M02,2,3,Pf3D7_12_v3,61435,377095,315660
SMI000-K04-B01-M02,2,3,Pf3D7_12_v3,382400,807679,425279
SMI000-K04-B01-M02,2,3,Pf3D7_13_v3,270924,1682933,1412009
SMI000-K04-B01-M02,2,3,Pf3D7_13_v3,2541529,2788579,247050
SMI000-K04-B01-M02,2,3,Pf3D7_14_v3,35796,312693,276897
SMI000-K04-B01-M02,2,3,Pf3D7_14_v3,420866,602104,181238
SMI000-K04-B01-M02,2,3,Pf3D7_14_v3,918720,1438616,519896
SMI001-K04-B01-M03,0,1,Pf3D7_01_v3,95518,567657,472139
SMI001-K04-B01-M03,0,1,Pf3D7_02_v3,109248,805840,696592
SMI001-K04-B01-M03,0,1,Pf3D7_03_v3,878750,1002946,124196
SMI001-K04-B01-M03,0,1,Pf3D7_04_v3,91817,1143965,1052148
SMI001-K04-B01-M03,0,1,Pf3D7_05_v3,39872,95628,55756
SMI001-K04-B01-M03,0,1,Pf3D7_05_v3,138524,1321074,1182550
SMI001-K04-B01-M03,0,1,Pf3D7_06_v3,74373,1294070,1219697
SMI001-K04-B01-M03,0,1,Pf3D7_07_v3,77194,132909,55715
SMI001-K04-B01-M03,0,1,Pf3D7_07_v3,202640,475850,273210
SMI001-K04-B01-M03,0,1,Pf3D7_07_v3,480458,1380526,900068
SMI001-K04-B01-M03,0,1,Pf3D7_08_v3,75691,1113495,1037804
SMI001-K04-B01-M03,0,1,Pf3D7_09_v3,164244,1461600,1297356
SMI001-K04-B01-M03,0,1,Pf3D7_10_v3,574773,1570149,995376
SMI001-K04-B01-M03,0,1,Pf3D7_11_v3,110641,812065,701424
SMI001-K04-B01-M03,0,1,Pf3D7_11_v3,902534,920192,17658
SMI001-K04-B01-M03,0,1,Pf3D7_11_v3,999375,1887740,888365
SMI001-K04-B01-M03,0,1,Pf3D7_11_v3,1997231,2003008,5777
SMI001-K04-B01-M03,0,1,Pf3D7_12_v3,61435,2045903,1984468
SMI001-K04-B01-M03,0,1,Pf3D7_13_v3,106161,1891015,1784854
SMI001-K04-B01-M03,0,1,Pf3D7_13_v3,1995595,2788579,792984
SMI001-K04-B01-M03,0,1,Pf3D7_14_v3,35796,109219,73423
SMI001-K04-B01-M03,0,1,Pf3D7_14_v3,161602,1926842,1765240
SMI001-K04-B01-M03,0,1,Pf3D7_14_v3,2006084,2451029,444945
SMI001-K04-B01-M03,0,1,Pf3D7_14_v3,3121601,3255607,134006
SMI001-K04-B01-M03,0,2,Pf3D7_01_v3,95518,509256,413738
SMI001-K04-B01-M03,0,2,Pf3D7_01_v3,530839,567657,36818
SMI001-K04-B01-M03,0,2,Pf3D7_02_v3,109248,322746,213498
SMI001-K04-B01-M03,0,2,Pf3D7_02_v3,468251,855754,387503
SMI001-K04-B01-M03,0,2,Pf3D7_04_v3,115195,128081,12886
SMI001-K04-B01-M03,0,2,Pf3D7_04_v3,255939,695742,439803
SMI001-K04-B01-M03,0,2,Pf3D7_04_v3,999012,1037656,38644
SMI001-K04-B01-M03,0,2,Pf3D7_05_v3,95628,138524,42896
SMI001-K04-B01-M03,0,2,Pf3D7_05_v3,374444,1317755,943311
SMI001-K04-B01-M03,0,2,Pf3D7_07_v3,376423,476732,100309
SMI001-K04-B01-M03,0,2,Pf3D7_07_v3,635759,990172,354413
SMI001-K04-B01-M03,0,2,Pf3D7_08_v3,1008257,1022491,14234
SMI001-K04-B01-M03,0,2,Pf3D7_09_v3,516978,1472334,955356
SMI001-K04-B01-M03,0,2,Pf3D7_10_v3,70764,511300,440536
SMI001-K04-B01-M03,0,2,Pf3D7_10_v3,574773,1014307,439534
SMI001-K04-B01-M03,0,2,Pf3D7_10_v3,1094351,1254230,159879
SMI001-K04-B01-M03,0,2,Pf3D7_10_v3,1570065,1570149,84
SMI001-K04-B01-M03,0,2,Pf3D7_11_v3,110641,902534,791893
SMI001-K04-B01-M03,0,2,Pf3D7_11_v3,920192,952563,32371
SMI001-K04-B01-M03,0,2,Pf3D7_11_v3,999375,1084422,85047
SMI001-K04-B01-M03,0,2,Pf3D7_11_v3,1294584,1295487,903
SMI001-K04-B01-M03,0,2,Pf3D7_11_v3,1543806,1695405,151599
SMI001-K04-B01-M03,0,2,Pf3D7_11_v3,1997231,2003008,5777
SMI001-K04-B01-M03,0,2,Pf3D7_12_v3,61435,122749,61314
SMI001-K04-B01-M03,0,2,Pf3D7_12_v3,382400,492095,109695
SMI001-K04-B01-M03,0,2,Pf3D7_12_v3,1020211,1085565,65354
SMI001-K04-B01-M03,0,2,Pf3D7_12_v3,1398887,2045903,647016
SMI001-K04-B01-M03,0,2,Pf3D7_13_v3,578051,1891015,1312964
SMI001-K04-B01-M03,0,2,Pf3D7_14_v3,637293,918720,281427
SMI001-K04-B01-M03,0,2,Pf3D7_14_v3,1926842,2006084,79242
SMI001-K04-B01-M03,0,2,Pf3D7_14_v3,3121601,3255607,134006
SMI001-K04-B01-M03,0,3,Pf3D7_01_v3,95518,509256,413738
SMI001-K04-B01-M03,0,3,Pf3D7_01_v3,530839,567657,36818
SMI001-K04-B01-M03,0,3,Pf3D7_02_v3,109248,322746,213498
SMI001-K04-B01-M03,0,3,Pf3D7_02_v3,468251,855754,387503
SMI001-K04-B01-M03,0,3,Pf3D7_04_v3,115195,128081,12886
SMI001-K04-B01-M03,0,3,Pf3D7_04_v3,255939,695742,439803
SMI001-K04-B01-M03,0,3,Pf3D7_04_v3,999012,1037656,38644
SMI001-K04-B01-M03,0,3,Pf3D7_05_v3,95628,138524,42896
SMI001-K04-B01-M03,0,3,Pf3D7_05_v3,374444,1317755,943311
SMI001-K04-B01-M03,0,3,Pf3D7_07_v3,376423,476732,100309
SMI001-K04-B01-M03,0,3,Pf3D7_07_v3,635759,990172,354413
SMI001-K04-B01-M03,0,3,Pf3D7_08_v3,1008257,1022491,14234
SMI001-K04-B01-M03,0,3,Pf3D7_09_v3,516978,1472334,955356
SMI001-K04-B01-M03,0,3,Pf3D7_10_v3,70764,511300,440536
SMI001-K04-B01-M03,0,3,Pf3D7_10_v3,574773,1014307,439534
SMI001-K04-B01-M03,0,3,Pf3D7_10_v3,1094351,1254230,159879
SMI001-K04-B01-M03,0,3,Pf3D7_10_v3,1570065,1570149,84
SMI001-K04-B01-M03,0,3,Pf3D7_11_v3,110641,902534,791893
SMI001-K04-B01-M03,0,3,Pf3D7_11_v3,920192,952563,32371
SMI001-K04-B01-M03,0,3,Pf3D7_11_v3,999375,1084422,85047
SMI001-K04-B01-M03,0,3,Pf3D7_11_v3,1294584,1295487,903
SMI001-K04-B01-M03,0,3,Pf3D7_11_v3,1543806,1695405,151599
SMI001-K04-B01-M03,0,3,Pf3D7_11_v3,1997231,2003008,5777
SMI001-K04-B01-M03,0,3,Pf3D7_12_v3,61435,122749,61314
SMI001-K04-B01-M03,0,3,Pf3D7_12_v3,382400,492095,109695
SMI001-K04-B01-M03,0,3,Pf3D7_12_v3,1020211,1085565,65354
SMI001-K04-B01-M03,0,3,Pf3D7_12_v3,1398887,2045903,647016
SMI001-K04-B01-M03,0,3,Pf3D7_13_v3,578051,1891015,1312964
SMI001-K04-B01-M03,0,3,Pf3D7_14_v3,637293,918720,281427
SMI001-K04-B01-M03,0,3,Pf3D7_14_v3,1926842,2006084,79242
SMI001-K04-B01-M03,0,3,Pf3D7_14_v3,3121601,3255607,134006
SMI001-K04-B01-M03,1,2,Pf3D7_01_v3,95518,509256,413738
SMI001-K04-B01-M03,1,2,Pf3D7_01_v3,530839,567657,36818
SMI001-K04-B01-M03,1,2,Pf3D7_02_v3,109248,322746,213498
SMI001-K04-B01-M03,1,2,Pf3D7_02_v3,468251,805840,337589
SMI001-K04-B01-M03,1,2,Pf3D7_02_v3,855754,862030,6276
SMI001-K04-B01-M03,1,2,Pf3D7_03_v3,71040,878750,807710
SMI001-K04-B01-M03,1,2,Pf3D7_04_v3,115195,128081,12886
SMI001-K04-B01-M03,1,2,Pf3D7_04_v3,255939,695742,439803
SMI001-K04-B01-M03,1,2,Pf3D7_04_v3,999012,1037656,38644
SMI001-K04-B01-M03,1,2,Pf3D7_05_v3,374444,1317755,943311
SMI001-K04-B01-M03,1,2,Pf3D7_07_v3,132909,202640,69731
SMI001-K04-B01-M03,1,2,Pf3D7_07_v3,376423,475850,99427
SMI001-K04-B01-M03,1,2,Pf3D7_07_v3,476732,480458,3726
SMI001-K04-B01-M03,1,2,Pf3D7_07_v3,635759,990172,354413
SMI001-K04-B01-M03,1,2,Pf3D7_08_v3,1008257,1022491,14234
SMI001-K04-B01-M03,1,2,Pf3D7_08_v3,1113495,1364499,251004
SMI001-K04-B01-M03,1,2,Pf3D7_09_v3,82153,164244,82091
SMI001-K04-B01-M03,1,2,Pf3D7_09_v3,516978,1461600,944622
SMI001-K04-B01-M03,1,2,Pf3D7_10_v3,511300,1014307,503007
SMI001-K04-B01-M03,1,2,Pf3D7_10_v3,1094351,1254230,159879
SMI001-K04-B01-M03,1,2,Pf3D7_10_v3,1570065,1570149,84
SMI001-K04-B01-M03,1,2,Pf3D7_11_v3,110641,812065,701424
SMI001-K04-B01-M03,1,2,Pf3D7_11_v3,952563,1084422,131859
SMI001-K04-B01-M03,1,2,Pf3D7_11_v3,1294584,1295487,903
SMI001-K04-B01-M03,1,2,Pf3D7_11_v3,1543806,1695405,151599
SMI001-K04-B01-M03,1,2,Pf3D7_11_v3,1887740,2003008,115268
SMI001-K04-B01-M03,1,2,Pf3D7_12_v3,61435,122749,61314
SMI001-K04-B01-M03,1,2,Pf3D7_12_v3,382400,492095,109695
SMI001-K04-B01-M03,1,2,Pf3D7_12_v3,1020211,1085565,65354
SMI001-K04-B01-M03,1,2,Pf3D7_12_v3,1398887,2155095,756208
SMI001-K04-B01-M03,1,2,Pf3D7_13_v3,77901,106161,28260
SMI001-K04-B01-M03,1,2,Pf3D7_13_v3,578051,1995595,1417544
SMI001-K04-B01-M03,1,2,Pf3D7_14_v3,109219,161602,52383
SMI001-K04-B01-M03,1,2,Pf3D7_14_v3,637293,918720,281427
SMI001-K04-B01-M03,1,2,Pf3D7_14_v3,2451029,3255607,804578
SMI001-K04-B01-M03,1,3,Pf3D7_01_v3,95518,509256,413738
SMI001-K04-B01-M03,1,3,Pf3D7_01_v3,530839,567657,36818
SMI001-K04-B01-M03,1,3,Pf3D7_02_v3,109248,322746,213498
SMI001-K04-B01-M03,1,3,Pf3D7_02_v3,468251,805840,337589
SMI001-K04-B01-M03,1,3,Pf3D7_02_v3,855754,862030,6276
SMI001-K04-B01-M03,1,3,Pf3D7_03_v3,71040,878750,807710
SMI001-K04-B01-M03,1,3,Pf3D7_04_v3,115195,128081,12886
SMI001-K04-B01-M03,1,3,Pf3D7_04_v3,255939,695742,439803
SMI001-K04-B01-M03,1,3,Pf3D7_04_v3,999012,1037656,38644
SMI001-K04-B01-M03,1,3,Pf3D7_05_v3,374444,1317755,943311
SMI001-K04-B01-M03,1,3,Pf3D7_07_v3,132909,202640,69731
SMI001-K04-B01-M03,1,3,Pf3D7_07_v3,376423,475850,99427
SMI001-K04-B01-M03,1,3,Pf3D7_07_v3,476732,480458,3726
SMI001-K04-B01-M03,1,3,Pf3D7_07_v3,635759,990172,354413
SMI001-K04-B01-M03,1,3,Pf3D7_08_v3,1008257,1022491,14234
SMI001-K04-B01-M03,1,3,Pf3D7_08_v3,1113495,1364499,251004
SMI001-K04-B01-M03,1,3,Pf3D7_09_v3,82153,164244,82091
SMI001-K04-B01-M03,1,3,Pf3D7_09_v3,516978,1461600,944622
SMI001-K04-B01-M03,1,3,Pf3D7_10_v3,511300,1014307,503007
SMI001-K04-B01-M03,1,3,Pf3D7_10_v3,1094351,1254230,159879
SMI001-K04-B01-M03,1,3,Pf3D7_10_v3,1570065,1570149,84
SMI001-K04-B01-M03,1,3,Pf3D7_11_v3,110641,812065,701424
SMI001-K04-B01-M03,1,3,Pf3D7_11_v3,952563,1084422,131859
SMI001-K04-B01-M03,1,3,Pf3D7_11_v3,1294584,1295487,903
SMI001-K04-B01-M03,1,3,Pf3D7_11_v3,1543806,1695405,151599
SMI001-K04-B01-M03,1,3,Pf3D7_11_v3,1887740,2003008,115268
SMI001-K04-B01-M03,1,3,Pf3D7_12_v3,61435,122749,61314
SMI001-K04-B01-M03,1,3,Pf3D7_12_v3,382400,492095,109695
SMI001-K04-B01-M03,1,3,Pf3D7_12_v3,1020211,1085565,65354
SMI001-K04-B01-M03,1,3,Pf3D7_12_v3,1398887,2155095,756208
SMI001-K04-B01-M03,1,3,Pf3D7_13_v3,77901,106161,28260
SMI001-K04-B01-M03,1,3,Pf3D7_13_v3,578051,1995595,1417544
SMI001-K04-B01-M03,1,3,Pf3D7_14_v3,109219,161602,52383
SMI001-K04-B01-M03,1,3,Pf3D7_14_v3,637293,918720,281427
SMI001-K04-B01-M03,1,3,Pf3D7_14_v3,2451029,3255607,804578
SMI001-K04-B01-M03,2,3,Pf3D7_01_v3,95518,567657,472139
SMI001-K04-B01-M03,2,3,Pf3D7_02_v3,109248,862030,752782
SMI001-K04-B01-M03,2,3,Pf3D7_03_v3,71040,1002946,931906
SMI001-K04-B01-M03,2,3,Pf3D7_04_v3,91817,1143965,1052148
SMI001-K04-B01-M03,2,3,Pf3D7_05_v3,39872,1321074,1281202
SMI001-K04-B01-M03,2,3,Pf3D7_06_v3,74373,1294070,1219697
SMI001-K04-B01-M03,2,3,Pf3D7_07_v3,77194,1380526,1303332
SMI001-K04-B01-M03,2,3,Pf3D7_08_v3,75691,1364499,1288808
SMI001-K04-B01-M03,2,3,Pf3D7_09_v3,82153,1472334,1390181
SMI001-K04-B01-M03,2,3,Pf3D7_10_v3,70764,1570149,1499385
SMI001-K04-B01-M03,2,3,Pf3D7_11_v3,110641,2003008,1892367
SMI001-K04-B01-M03,2,3,Pf3D7_12_v3,61435,2155095,2093660
SMI001-K04-B01-M03,2,3,Pf3D7_13_v3,77901,2788579,2710678
SMI001-K04-B01-M03,2,3,Pf3D7_14_v3,35796,3255607,3219811
SMI004-K04-B02-M01,0,1,Pf3D7_01_v3,196974,238688,41714
SMI004-K04-B02-M01,0,1,Pf3D7_01_v3,530839,567657,36818
SMI004-K04-B02-M01,0,1,Pf3D7_02_v3,109248,862030,752782
SMI004-K04-B02-M01,0,1,Pf3D7_03_v3,71040,1002946,931906
SMI004-K04-B02-M01,0,1,Pf3D7_04_v3,91817,991236,899419
SMI004-K04-B02-M01,0,1,Pf3D7_04_v3,999012,1055339,56327
SMI004-K04-B02-M01,0,1,Pf3D7_04_v3,1080103,1093508,13405
SMI004-K04-B02-M01,0,1,Pf3D7_04_v3,1100297,1101101,804
SMI004-K04-B02-M01,0,1,Pf3D7_04_v3,1137058,1143965,6907
SMI004-K04-B02-M01,0,1,Pf3D7_05_v3,39872,1321074,1281202
SMI004-K04-B02-M01,0,1,Pf3D7_06_v3,74373,803623,729250
SMI004-K04-B02-M01,0,1,Pf3D7_06_v3,859352,1294070,434718
SMI004-K04-B02-M01,0,1,Pf3D7_07_v3,77194,122637,45443
SMI004-K04-B02-M01,0,1,Pf3D7_08_v3,308234,364033,55799
SMI004-K04-B02-M01,0,1,Pf3D7_08_v3,470004,1227962,757958
SMI004-K04-B02-M01,0,1,Pf3D7_09_v3,110142,1141801,1031659
SMI004-K04-B02-M01,0,1,Pf3D7_10_v3,113505,223432,109927
SMI004-K04-B02-M01,0,1,Pf3D7_10_v3,1254230,1570149,315919
SMI004-K04-B02-M01,0,1,Pf3D7_11_v3,110641,115512,4871
SMI004-K04-B02-M01,0,1,Pf3D7_11_v3,487557,807246,319689
SMI004-K04-B02-M01,0,1,Pf3D7_11_v3,1256754,1446717,189963
SMI004-K04-B02-M01,0,1,Pf3D7_11_v3,2002782,2003008,226
SMI004-K04-B02-M01,0,1,Pf3D7_12_v3,61435,382400,320965
SMI004-K04-B02-M01,0,1,Pf3D7_12_v3,817686,1670700,853014
SMI004-K04-B02-M01,0,1,Pf3D7_13_v3,541473,860281,318808
SMI004-K04-B02-M01,0,1,Pf3D7_14_v3,442110,501766,59656
SMI004-K04-B02-M01,0,1,Pf3D7_01_v3,132574,528354,395780
SMI004-K04-B02-M01,0,1,Pf3D7_02_v3,166372,784379,618007
SMI004-K04-B02-M01,0,1,Pf3D7_04_v3,129448,276127,146679
SMI004-K04-B02-M01,0,1,Pf3D7_04_v3,888001,999012,111011
SMI004-K04-B02-M01,0,1,Pf3D7_05_v3,1108445,1321074,212629
SMI004-K04-B02-M01,0,1,Pf3D7_06_v3,74373,516710,442337
SMI004-K04-B02-M01,0,1,Pf3D7_06_v3,628195,1294070,665875
SMI004-K04-B02-M01,0,1,Pf3D7_07_v3,77194,619957,542763
SMI004-K04-B02-M01,0,1,Pf3D7_08_v3,424720,707340,282620
SMI004-K04-B02-M01,0,1,Pf3D7_08_v3,1312133,1315035,2902
SMI004-K04-B02-M01,0,1,Pf3D7_09_v3,556935,602663,45728
SMI004-K04-B02-M01,0,1,Pf3D7_09_v3,723918,1014530,290612
SMI004-K04-B02-M01,0,1,Pf3D7_09_v3,1469377,1472334,2957
SMI004-K04-B02-M01,0,1,Pf3D7_10_v3,70764,669306,598542
SMI004-K04-B02-M01,0,1,Pf3D7_10_v3,1254230,1570149,315919
SMI004-K04-B02-M01,0,1,Pf3D7_11_v3,110641,2003008,1892367
SMI004-K04-B02-M01,0,1,Pf3D7_12_v3,61435,1114059,1052624
SMI004-K04-B02-M01,0,1,Pf3D7_12_v3,1670700,2136656,465956
SMI004-K04-B02-M01,0,1,Pf3D7_13_v3,585306,2575636,1990330
SMI004-K04-B02-M01,0,1,Pf3D7_14_v3,338453,1069989,731536
SMI004-K04-B02-M01,0,1,Pf3D7_14_v3,1158319,1199242,40923
SMI004-K04-B02-M01,0,1,Pf3D7_14_v3,2753325,3255607,502282
SMI005-K04-B03-M03,0,1,Pf3D7_01_v3,95518,308232,212714
SMI005-K04-B03-M03,0,1,Pf3D7_02_v3,339959,862030,522071
SMI005-K04-B03-M03,0,1,Pf3D7_03_v3,71040,1002946,931906
SMI005-K04-B03-M03,0,1,Pf3D7_04_v3,91817,1143965,1052148
SMI005-K04-B03-M03,0,1,Pf3D7_05_v3,39872,286660,246788
SMI005-K04-B03-M03,0,1,Pf3D7_05_v3,1038517,1321074,282557
SMI005-K04-B03-M03,0,1,Pf3D7_06_v3,74373,815124,740751
SMI005-K04-B03-M03,0,1,Pf3D7_06_v3,824200,834384,10184
SMI005-K04-B03-M03,0,1,Pf3D7_06_v3,1289167,1294070,4903
SMI005-K04-B03-M03,0,1,Pf3D7_07_v3,77194,1380526,1303332
SMI005-K04-B03-M03,0,1,Pf3D7_08_v3,75691,305487,229796
SMI005-K04-B03-M03,0,1,Pf3D7_08_v3,471213,1278610,807397
SMI005-K04-B03-M03,0,1,Pf3D7_08_v3,1289102,1311598,22496
SMI005-K04-B03-M03,0,1,Pf3D7_08_v3,1330342,1364499,34157
SMI005-K04-B03-M03,0,1,Pf3D7_09_v3,82153,1472334,1390181
SMI005-K04-B03-M03,0,1,Pf3D7_10_v3,70764,1570149,1499385
SMI005-K04-B03-M03,0,1,Pf3D7_11_v3,110641,778298,667657
SMI005-K04-B03-M03,0,1,Pf3D7_11_v3,865260,2001019,1135759
SMI005-K04-B03-M03,0,1,Pf3D7_12_v3,354795,532133,177338
SMI005-K04-B03-M03,0,1,Pf3D7_12_v3,749219,2155095,1405876
SMI005-K04-B03-M03,0,1,Pf3D7_13_v3,77901,127110,49209
SMI005-K04-B03-M03,0,1,Pf3D7_13_v3,367468,872241,504773
SMI005-K04-B03-M03,0,1,Pf3D7_13_v3,1891015,2788579,897564
SMI005-K04-B03-M03,0,1,Pf3D7_14_v3,35796,3255607,3219811
SMI006-K04-B02-M02,0,1,Pf3D7_01_v3,178474,567657,389183
SMI006-K04-B02-M02,0,1,Pf3D7_02_v3,109248,166372,57124
SMI006-K04-B02-M02,0,1,Pf3D7_02_v3,405079,468251,63172
SMI006-K04-B02-M02,0,1,Pf3D7_02_v3,630737,805840,175103
SMI006-K04-B02-M02,0,1,Pf3D7_03_v3,357947,362531,4584
SMI006-K04-B02-M02,0,1,Pf3D7_03_v3,501876,509618,7742
SMI006-K04-B02-M02,0,1,Pf3D7_03_v3,878750,1002946,124196
SMI006-K04-B02-M02,0,1,Pf3D7_04_v3,91817,147659,55842
SMI006-K04-B02-M02,0,1,Pf3D7_04_v3,255939,777043,521104
SMI006-K04-B02-M02,0,1,Pf3D7_04_v3,863561,901771,38210
SMI006-K04-B02-M02,0,1,Pf3D7_04_v3,1100339,1143965,43626
SMI006-K04-B02-M02,0,1,Pf3D7_05_v3,39872,391101,351229
SMI006-K04-B02-M02,0,1,Pf3D7_05_v3,615300,669642,54342
SMI006-K04-B02-M02,0,1,Pf3D7_05_v3,951120,1204155,253035
SMI006-K04-B02-M02,0,1,Pf3D7_06_v3,1002835,1111651,108816
SMI006-K04-B02-M02,0,1,Pf3D7_07_v3,85076,476732,391656
SMI006-K04-B02-M02,0,1,Pf3D7_07_v3,619398,1380526,761128
SMI006-K04-B02-M02,0,1,Pf3D7_08_v3,75691,740134,664443
SMI006-K04-B02-M02,0,1,Pf3D7_08_v3,1278610,1290560,11950
SMI006-K04-B02-M02,0,1,Pf3D7_08_v3,1310665,1315811,5146
SMI006-K04-B02-M02,0,1,Pf3D7_09_v3,159227,370705,211478
SMI006-K04-B02-M02,0,1,Pf3D7_09_v3,492627,850094,357467
SMI006-K04-B02-M02,0,1,Pf3D7_10_v3,675913,1111441,435528
SMI006-K04-B02-M02,0,1,Pf3D7_10_v3,1397850,1570149,172299
SMI006-K04-B02-M02,0,1,Pf3D7_11_v3,110641,154299,43658
SMI006-K04-B02-M02,0,1,Pf3D7_11_v3,778298,901414,123116
SMI006-K04-B02-M02,0,1,Pf3D7_12_v3,382400,733520,351120
SMI006-K04-B02-M02,0,1,Pf3D7_12_v3,1670700,2155095,484395
SMI006-K04-B02-M02,0,1,Pf3D7_13_v3,77901,106161,28260
SMI006-K04-B02-M02,0,1,Pf3D7_13_v3,1891015,2408374,517359
SMI006-K04-B02-M02,0,1,Pf3D7_13_v3,2575636,2788579,212943
SMI006-K04-B02-M02,0,1,Pf3D7_14_v3,35796,918720,882924
SMI006-K04-B02-M02,0,2,Pf3D7_01_v3,472576,496805,24229
SMI006-K04-B02-M02,0,2,Pf3D7_02_v3,405079,468251,63172
SMI006-K04-B02-M02,0,2,Pf3D7_02_v3,630737,862030,231293
SMI006-K04-B02-M02,0,2,Pf3D7_03_v3,71040,878750,807710
SMI006-K04-B02-M02,0,2,Pf3D7_04_v3,255939,777043,521104
SMI006-K04-B02-M02,0,2,Pf3D7_04_v3,902548,1143965,241417
SMI006-K04-B02-M02,0,2,Pf3D7_05_v3,39872,1321074,1281202
SMI006-K04-B02-M02,0,2,Pf3D7_06_v3,74373,116607,42234
SMI006-K04-B02-M02,0,2,Pf3D7_06_v3,1002835,1111651,108816
SMI006-K04-B02-M02,0,2,Pf3D7_07_v3,85076,410132,325056
SMI006-K04-B02-M02,0,2,Pf3D7_07_v3,476732,619398,142666
SMI006-K04-B02-M02,0,2,Pf3D7_07_v3,619957,1380526,760569
SMI006-K04-B02-M02,0,2,Pf3D7_08_v3,75691,740134,664443
SMI006-K04-B02-M02,0,2,Pf3D7_08_v3,1031401,1167918,136517
SMI006-K04-B02-M02,0,2,Pf3D7_08_v3,1290560,1310665,20105
SMI006-K04-B02-M02,0,2,Pf3D7_09_v3,152398,492627,340229
SMI006-K04-B02-M02,0,2,Pf3D7_10_v3,675913,1111441,435528
SMI006-K04-B02-M02,0,2,Pf3D7_10_v3,1254230,1394114,139884
SMI006-K04-B02-M02,0,2,Pf3D7_10_v3,1397850,1570149,172299
SMI006-K04-B02-M02,0,2,Pf3D7_11_v3,110641,154299,43658
SMI006-K04-B02-M02,0,2,Pf3D7_11_v3,778298,901414,123116
SMI006-K04-B02-M02,0,2,Pf3D7_11_v3,1375053,2003008,627955
SMI006-K04-B02-M02,0,2,Pf3D7_12_v3,61435,726602,665167
SMI006-K04-B02-M02,0,2,Pf3D7_12_v3,733520,892467,158947
SMI006-K04-B02-M02,0,2,Pf3D7_12_v3,1670700,2155095,484395
SMI006-K04-B02-M02,0,2,Pf3D7_13_v3,77901,1103578,1025677
SMI006-K04-B02-M02,0,2,Pf3D7_13_v3,1891015,2408374,517359
SMI006-K04-B02-M02,0,2,Pf3D7_14_v3,336220,918720,582500
SMI006-K04-B02-M02,0,2,Pf3D7_14_v3,2231863,2733656,501793
SMI006-K04-B02-M02,0,2,Pf3D7_14_v3,3127658,3255607,127949
SMI006-K04-B02-M02,1,2,Pf3D7_01_v3,95518,178474,82956
SMI006-K04-B02-M02,1,2,Pf3D7_01_v3,472576,496805,24229
SMI006-K04-B02-M02,1,2,Pf3D7_02_v3,166372,805840,639468
SMI006-K04-B02-M02,1,2,Pf3D7_03_v3,357947,362531,4584
SMI006-K04-B02-M02,1,2,Pf3D7_03_v3,501876,509618,7742
SMI006-K04-B02-M02,1,2,Pf3D7_04_v3,147659,863561,715902
SMI006-K04-B02-M02,1,2,Pf3D7_04_v3,901771,902548,777
SMI006-K04-B02-M02,1,2,Pf3D7_04_v3,1100339,1143965,43626
SMI006-K04-B02-M02,1,2,Pf3D7_05_v3,39872,391101,351229
SMI006-K04-B02-M02,1,2,Pf3D7_05_v3,615300,669642,54342
SMI006-K04-B02-M02,1,2,Pf3D7_05_v3,951120,1204155,253035
SMI006-K04-B02-M02,1,2,Pf3D7_06_v3,116607,1294070,1177463
SMI006-K04-B02-M02,1,2,Pf3D7_07_v3,77194,410132,332938
SMI006-K04-B02-M02,1,2,Pf3D7_07_v3,619957,1380526,760569
SMI006-K04-B02-M02,1,2,Pf3D7_08_v3,75691,1031401,955710
SMI006-K04-B02-M02,1,2,Pf3D7_08_v3,1167918,1278610,110692
SMI006-K04-B02-M02,1,2,Pf3D7_08_v3,1315811,1364499,48688
SMI006-K04-B02-M02,1,2,Pf3D7_09_v3,82153,152398,70245
SMI006-K04-B02-M02,1,2,Pf3D7_09_v3,159227,370705,211478
SMI006-K04-B02-M02,1,2,Pf3D7_09_v3,850094,1472334,622240
SMI006-K04-B02-M02,1,2,Pf3D7_10_v3,70764,1254230,1183466
SMI006-K04-B02-M02,1,2,Pf3D7_10_v3,1394114,1570149,176035
SMI006-K04-B02-M02,1,2,Pf3D7_11_v3,110641,1375053,1264412
SMI006-K04-B02-M02,1,2,Pf3D7_12_v3,382400,726602,344202
SMI006-K04-B02-M02,1,2,Pf3D7_12_v3,892467,2155095,1262628
SMI006-K04-B02-M02,1,2,Pf3D7_13_v3,77901,106161,28260
SMI006-K04-B02-M02,1,2,Pf3D7_13_v3,1103578,2575636,1472058
SMI006-K04-B02-M02,1,2,Pf3D7_14_v3,336220,2231863,1895643
SMI006-K04-B02-M02,1,2,Pf3D7_14_v3,2733656,3127658,394002
SMI007-K04-B01-M01,0,1,Pf3D7_02_v3,434163,805840,371677
SMI007-K04-B01-M01,0,1,Pf3D7_03_v3,562561,1002946,440385
SMI007-K04-B01-M01,0,1,Pf3D7_04_v3,91817,255939,164122
SMI007-K04-B01-M01,0,1,Pf3D7_04_v3,615475,650240,34765
SMI007-K04-B01-M01,0,1,Pf3D7_04_v3,1130657,1143965,13308
SMI007-K04-B01-M01,0,1,Pf3D7_05_v3,39872,144161,104289
SMI007-K04-B01-M01,0,1,Pf3D7_05_v3,288857,610054,321197
SMI007-K04-B01-M01,0,1,Pf3D7_06_v3,542924,765398,222474
SMI007-K04-B01-M01,0,1,Pf3D7_06_v3,1111651,1289167,177516
SMI007-K04-B01-M01,0,1,Pf3D7_08_v3,1278610,1364499,85889
SMI007-K04-B01-M01,0,1,Pf3D7_09_v3,82153,417453,335300
SMI007-K04-B01-M01,0,1,Pf3D7_09_v3,1204326,1472334,268008
SMI007-K04-B01-M01,0,1,Pf3D7_10_v3,70764,108293,37529
SMI007-K04-B01-M01,0,1,Pf3D7_11_v3,535357,1294584,759227
SMI007-K04-B01-M01,0,1,Pf3D7_11_v3,1295033,1295487,454
SMI007-K04-B01-M01,0,1,Pf3D7_12_v3,382400,733520,351120
SMI007-K04-B01-M01,0,1,Pf3D7_13_v3,106085,2046191,1940106
SMI007-K04-B01-M01,0,1,Pf3D7_13_v3,2575636,2788579,212943
SMI007-K04-B01-M01,0,1,Pf3D7_14_v3,35796,377103,341307
SMI007-K04-B01-M01,0,1,Pf3D7_14_v3,918720,2231863,1313143
SMI007-K04-B01-M01,0,2,Pf3D7_04_v3,766795,796416,29621
SMI007-K04-B01-M01,0,2,Pf3D7_04_v3,999012,1130657,131645
SMI007-K04-B01-M01,0,2,Pf3D7_05_v3,236079,288857,52778
SMI007-K04-B01-M01,0,2,Pf3D7_05_v3,610054,925815,315761
SMI007-K04-B01-M01,0,2,Pf3D7_06_v3,765398,1111651,346253
SMI007-K04-B01-M01,0,2,Pf3D7_07_v3,620660,1380526,759866
SMI007-K04-B01-M01,0,2,Pf3D7_08_v3,75691,83708,8017
SMI007-K04-B01-M01,0,2,Pf3D7_08_v3,117802,424720,306918
SMI007-K04-B01-M01,0,2,Pf3D7_08_v3,1109232,1227962,118730
SMI007-K04-B01-M01,0,2,Pf3D7_09_v3,417453,1204326,786873
SMI007-K04-B01-M01,0,2,Pf3D7_11_v3,1294584,1295033,449
SMI007-K04-B01-M01,0,2,Pf3D7_11_v3,1978659,2003008,24349
SMI007-K04-B01-M01,0,2,Pf3D7_12_v3,61435,382400,320965
SMI007-K04-B01-M01,0,2,Pf3D7_12_v3,929131,2155095,1225964
SMI007-K04-B01-M01,0,2,Pf3D7_13_v3,77901,106085,28184
SMI007-K04-B01-M01,0,2,Pf3D7_14_v3,377103,495013,117910
SMI007-K04-B01-M01,0,2,Pf3D7_14_v3,2231863,3255607,1023744
SMI007-K04-B01-M01,0,3,Pf3D7_01_v3,95518,567657,472139
SMI007-K04-B01-M01,0,3,Pf3D7_02_v3,109248,434163,324915
SMI007-K04-B01-M01,0,3,Pf3D7_02_v3,805840,862030,56190
SMI007-K04-B01-M01,0,3,Pf3D7_03_v3,71040,562561,491521
SMI007-K04-B01-M01,0,3,Pf3D7_04_v3,255939,615475,359536
SMI007-K04-B01-M01,0,3,Pf3D7_04_v3,650240,766795,116555
SMI007-K04-B01-M01,0,3,Pf3D7_04_v3,796416,999012,202596
SMI007-K04-B01-M01,0,3,Pf3D7_05_v3,144161,236079,91918
SMI007-K04-B01-M01,0,3,Pf3D7_05_v3,925815,1321074,395259
SMI007-K04-B01-M01,0,3,Pf3D7_06_v3,74373,542924,468551
SMI007-K04-B01-M01,0,3,Pf3D7_06_v3,1289167,1294070,4903
SMI007-K04-B01-M01,0,3,Pf3D7_07_v3,77194,620660,543466
SMI007-K04-B01-M01,0,3,Pf3D7_08_v3,83708,117802,34094
SMI007-K04-B01-M01,0,3,Pf3D7_08_v3,424720,1109232,684512
SMI007-K04-B01-M01,0,3,Pf3D7_08_v3,1227962,1278610,50648
SMI007-K04-B01-M01,0,3,Pf3D7_10_v3,108293,1570149,1461856
SMI007-K04-B01-M01,0,3,Pf3D7_11_v3,110641,535357,424716
SMI007-K04-B01-M01,0,3,Pf3D7_11_v3,1295487,1978659,683172
SMI007-K04-B01-M01,0,3,Pf3D7_12_v3,733520,929131,195611
SMI007-K04-B01-M01,0,3,Pf3D7_13_v3,2046191,2575636,529445
SMI007-K04-B01-M01,0,3,Pf3D7_14_v3,495013,918720,423707
SMI007-K04-B01-M01,1,2,Pf3D7_01_v3,95518,567657,472139
SMI007-K04-B01-M01,1,2,Pf3D7_02_v3,109248,434163,324915
SMI007-K04-B01-M01,1,2,Pf3D7_02_v3,805840,862030,56190
SMI007-K04-B01-M01,1,2,Pf3D7_03_v3,71040,562561,491521
SMI007-K04-B01-M01,1,2,Pf3D7_04_v3,255939,615475,359536
SMI007-K04-B01-M01,1,2,Pf3D7_04_v3,650240,766795,116555
SMI007-K04-B01-M01,1,2,Pf3D7_04_v3,796416,999012,202596
SMI007-K04-B01-M01,1,2,Pf3D7_05_v3,144161,236079,91918
SMI007-K04-B01-M01,1,2,Pf3D7_05_v3,925815,1321074,395259
SMI007-K04-B01-M01,1,2,Pf3D7_06_v3,74373,542924,468551
SMI007-K04-B01-M01,1,2,Pf3D7_06_v3,1289167,1294070,4903
SMI007-K04-B01-M01,1,2,Pf3D7_07_v3,77194,620660,543466
SMI007-K04-B01-M01,1,2,Pf3D7_08_v3,83708,117802,34094
SMI007-K04-B01-M01,1,2,Pf3D7_08_v3,424720,1109232,684512
SMI007-K04-B01-M01,1,2,Pf3D7_08_v3,1227962,1278610,50648
SMI007-K04-B01-M01,1,2,Pf3D7_10_v3,108293,1570149,1461856
SMI007-K04-B01-M01,1,2,Pf3D7_11_v3,110641,535357,424716
SMI007-K04-B01-M01,1,2,Pf3D7_11_v3,1295487,1978659,683172
SMI007-K04-B01-M01,1,2,Pf3D7_12_v3,733520,929131,195611
SMI007-K04-B01-M01,1,2,Pf3D7_13_v3,2046191,2575636,529445
SMI007-K04-B01-M01,1,2,Pf3D7_14_v3,495013,918720,423707
SMI007-K04-B01-M01,1,3,Pf3D7_04_v3,766795,796416,29621
SMI007-K04-B01-M01,1,3,Pf3D7_04_v3,999012,1130657,131645
SMI007-K04-B01-M01,1,3,Pf3D7_05_v3,236079,288857,52778
SMI007-K04-B01-M01,1,3,Pf3D7_05_v3,610054,925815,315761
SMI007-K04-B01-M01,1,3,Pf3D7_06_v3,765398,1111651,346253
SMI007-K04-B01-M01,1,3,Pf3D7_07_v3,620660,1380526,759866
SMI007-K04-B01-M01,1,3,Pf3D7_08_v3,75691,83708,8017
SMI007-K04-B01-M01,1,3,Pf3D7_08_v3,117802,424720,306918
SMI007-K04-B01-M01,1,3,Pf3D7_08_v3,1109232,1227962,118730
SMI007-K04-B01-M01,1,3,Pf3D7_09_v3,417453,1204326,786873
SMI007-K04-B01-M01,1,3,Pf3D7_11_v3,1294584,1295033,449
SMI007-K04-B01-M01,1,3,Pf3D7_11_v3,1978659,2003008,24349
SMI007-K04-B01-M01,1,3,Pf3D7_12_v3,61435,382400,320965
SMI007-K04-B01-M01,1,3,Pf3D7_12_v3,929131,2155095,1225964
SMI007-K04-B01-M01,1,3,Pf3D7_13_v3,77901,106085,28184
SMI007-K04-B01-M01,1,3,Pf3D7_14_v3,377103,495013,117910
SMI007-K04-B01-M01,1,3,Pf3D7_14_v3,2231863,3255607,1023744
SMI007-K04-B01-M01,2,3,Pf3D7_02_v3,434163,805840,371677
SMI007-K04-B01-M01,2,3,Pf3D7_03_v3,562561,1002946,440385
SMI007-K04-B01-M01,2,3,Pf3D7_04_v3,91817,255939,164122
SMI007-K04-B01-M01,2,3,Pf3D7_04_v3,615475,650240,34765
SMI007-K04-B01-M01,2,3,Pf3D7_04_v3,1130657,1143965,13308
SMI007-K04-B01-M01,2,3,Pf3D7_05_v3,39872,144161,104289
SMI007-K04-B01-M01,2,3,Pf3D7_05_v3,288857,610054,321197
SMI007-K04-B01-M01,2,3,Pf3D7_06_v3,542924,765398,222474
SMI007-K04-B01-M01,2,3,Pf3D7_06_v3,1111651,1289167,177516
SMI007-K04-B01-M01,2,3,Pf3D7_08_v3,1278610,1364499,85889
SMI007-K04-B01-M01,2,3,Pf3D7_09_v3,82153,417453,335300
SMI007-K04-B01-M01,2,3,Pf3D7_09_v3,1204326,1472334,268008
SMI007-K04-B01-M01,2,3,Pf3D7_10_v3,70764,108293,37529
SMI007-K04-B01-M01,2,3,Pf3D7_11_v3,535357,1294584,759227
SMI007-K04-B01-M01,2,3,Pf3D7_11_v3,1295033,1295487,454
SMI007-K04-B01-M01,2,3,Pf3D7_12_v3,382400,733520,351120
SMI007-K04-B01-M01,2,3,Pf3D7_13_v3,106085,2046191,1940106
SMI007-K04-B01-M01,2,3,Pf3D7_13_v3,2575636,2788579,212943
SMI007-K04-B01-M01,2,3,Pf3D7_14_v3,35796,377103,341307
SMI007-K04-B01-M01,2,3,Pf3D7_14_v3,918720,2231863,1313143
SMI008-K04-B03-M03,0,1,Pf3D7_01_v3,95518,567657,472139
SMI008-K04-B03-M03,0,1,Pf3D7_02_v3,109248,862030,752782
SMI008-K04-B03-M03,0,1,Pf3D7_03_v3,71040,241146,170106
SMI008-K04-B03-M03,0,1,Pf3D7_03_v3,654499,1002946,348447
SMI008-K04-B03-M03,0,1,Pf3D7_04_v3,91817,255939,164122
SMI008-K04-B03-M03,0,1,Pf3D7_04_v3,528936,832042,303106
SMI008-K04-B03-M03,0,1,Pf3D7_04_v3,929397,1143965,214568
SMI008-K04-B03-M03,0,1,Pf3D7_05_v3,39872,1204155,1164283
SMI008-K04-B03-M03,0,1,Pf3D7_05_v3,1316719,1321074,4355
SMI008-K04-B03-M03,0,1,Pf3D7_06_v3,74373,796597,722224
SMI008-K04-B03-M03,0,1,Pf3D7_06_v3,884526,1287766,403240
SMI008-K04-B03-M03,0,1,Pf3D7_07_v3,150143,197008,46865
SMI008-K04-B03-M03,0,1,Pf3D7_07_v3,204876,488471,283595
SMI008-K04-B03-M03,0,1,Pf3D7_07_v3,619957,1380526,760569
SMI008-K04-B03-M03,0,1,Pf3D7_08_v3,75691,469245,393554
SMI008-K04-B03-M03,0,1,Pf3D7_08_v3,475591,1239302,763711
SMI008-K04-B03-M03,0,1,Pf3D7_08_v3,1278610,1364499,85889
SMI008-K04-B03-M03,0,1,Pf3D7_09_v3,82153,203070,120917
SMI008-K04-B03-M03,0,1,Pf3D7_09_v3,416031,1472334,1056303
SMI008-K04-B03-M03,0,1,Pf3D7_10_v3,70764,1570149,1499385
SMI008-K04-B03-M03,0,1,Pf3D7_11_v3,110641,1294843,1184202
SMI008-K04-B03-M03,0,1,Pf3D7_11_v3,1375053,2003008,627955
SMI008-K04-B03-M03,0,1,Pf3D7_12_v3,61435,2155095,2093660
SMI008-K04-B03-M03,0,1,Pf3D7_13_v3,77901,1359289,1281388
SMI008-K04-B03-M03,0,1,Pf3D7_13_v3,1891015,2788579,897564
SMI008-K04-B03-M03,0,1,Pf3D7_14_v3,35796,1562642,1526846
SMI008-K04-B03-M03,0,1,Pf3D7_14_v3,1657395,2164225,506830
SMI008-K04-B03-M03,0,1,Pf3D7_14_v3,2231863,3043747,811884
SMI008-K04-B03-M03,0,1,Pf3D7_14_v3,3125454,3255607,130153
SMI009-K04-B03-M01,0,1,Pf3D7_01_v3,180068,567657,387589
SMI009-K04-B03-M01,0,1,Pf3D7_02_v3,109248,805840,696592
SMI009-K04-B03-M01,0,1,Pf3D7_04_v3,255939,830755,574816
SMI009-K04-B03-M01,0,1,Pf3D7_04_v3,1137058,1143965,6907
SMI009-K04-B03-M01,0,1,Pf3D7_05_v3,39872,92082,52210
SMI009-K04-B03-M01,0,1,Pf3D7_05_v3,796714,1171322,374608
SMI009-K04-B03-M01,0,1,Pf3D7_06_v3,284496,967350,682854
SMI009-K04-B03-M01,0,1,Pf3D7_06_v3,1111651,1289167,177516
SMI009-K04-B03-M01,0,1,Pf3D7_08_v3,1278610,1364499,85889
SMI009-K04-B03-M01,0,1,Pf3D7_09_v3,82153,203308,121155
SMI009-K04-B03-M01,0,1,Pf3D7_09_v3,900277,1472334,572057
SMI009-K04-B03-M01,0,1,Pf3D7_10_v3,70764,238016,167252
SMI009-K04-B03-M01,0,1,Pf3D7_10_v3,444064,1254230,810166
SMI009-K04-B03-M01,0,1,Pf3D7_11_v3,408413,694933,286520
SMI009-K04-B03-M01,0,1,Pf3D7_12_v3,63177,382400,319223
SMI009-K04-B03-M01,0,1,Pf3D7_12_v3,817280,907264,89984
SMI009-K04-B03-M01,0,1,Pf3D7_13_v3,2575636,2788579,212943
SMI009-K04-B03-M01,0,1,Pf3D7_14_v3,35796,877704,841908
SMI009-K04-B03-M01,0,1,Pf3D7_14_v3,918720,3124899,2206179
SMI011-K04-B01-M02,0,1,Pf3D7_01_v3,95518,567657,472139
SMI011-K04-B01-M02,0,1,Pf3D7_02_v3,109248,468251,359003
SMI011-K04-B01-M02,0,1,Pf3D7_03_v3,152653,510722,358069
SMI011-K04-B01-M02,0,1,Pf3D7_04_v3,255939,925583,669644
SMI011-K04-B01-M02,0,1,Pf3D7_04_v3,1042880,1143965,101085
SMI011-K04-B01-M02,0,1,Pf3D7_05_v3,39872,1263168,1223296
SMI011-K04-B01-M02,0,1,Pf3D7_06_v3,681253,833542,152289
SMI011-K04-B01-M02,0,1,Pf3D7_06_v3,1115191,1182560,67369
SMI011-K04-B01-M02,0,1,Pf3D7_07_v3,477049,477426,377
SMI011-K04-B01-M02,0,1,Pf3D7_07_v3,619957,1129144,509187
SMI011-K04-B01-M02,0,1,Pf3D7_07_v3,1326844,1380526,53682
SMI011-K04-B01-M02,0,1,Pf3D7_08_v3,75691,1278610,1202919
SMI011-K04-B01-M02,0,1,Pf3D7_08_v3,1313796,1364499,50703
SMI011-K04-B01-M02,0,1,Pf3D7_09_v3,82153,416031,333878
SMI011-K04-B01-M02,0,1,Pf3D7_09_v3,1214930,1472334,257404
SMI011-K04-B01-M02,0,1,Pf3D7_10_v3,70764,74759,3995
SMI011-K04-B01-M02,0,1,Pf3D7_10_v3,700215,1254230,554015
SMI011-K04-B01-M02,0,1,Pf3D7_10_v3,1399091,1570149,171058
SMI011-K04-B01-M02,0,1,Pf3D7_11_v3,110641,778298,667657
SMI011-K04-B01-M02,0,1,Pf3D7_11_v3,796591,999375,202784
SMI011-K04-B01-M02,0,1,Pf3D7_11_v3,1019067,1293971,274904
SMI011-K04-B01-M02,0,1,Pf3D7_11_v3,1295487,2003008,707521
SMI011-K04-B01-M02,0,1,Pf3D7_12_v3,61435,122749,61314
SMI011-K04-B01-M02,0,1,Pf3D7_12_v3,418961,1281594,862633
SMI011-K04-B01-M02,0,1,Pf3D7_12_v3,1341970,1387200,45230
SMI011-K04-B01-M02,0,1,Pf3D7_12_v3,1670700,2145373,474673
SMI011-K04-B01-M02,0,1,Pf3D7_13_v3,150114,953193,803079
SMI011-K04-B01-M02,0,1,Pf3D7_13_v3,1155190,2788579,1633389
SMI011-K04-B01-M02,0,1,Pf3D7_14_v3,35796,40665,4869
SMI011-K04-B01-M02,0,1,Pf3D7_14_v3,407424,918720,511296
SMI011-K04-B01-M02,0,1,Pf3D7_14_v3,1380024,1992946,612922
SMI011-K04-B01-M02,0,1,Pf3D7_14_v3,2020660,2231863,211203
SMI011-K04-B01-M02,0,1,Pf3D7_14_v3,2816765,2886352,69587
SMI011-K04-B01-M02,0,1,Pf3D7_14_v3,3124731,3163741,39010
SMI011-K04-B01-M02,0,2,Pf3D7_01_v3,95518,163071,67553
SMI011-K04-B01-M02,0,2,Pf3D7_02_v3,468251,614624,146373
SMI011-K04-B01-M02,0,2,Pf3D7_03_v3,152653,183105,30452
SMI011-K04-B01-M02,0,2,Pf3D7_03_v3,717928,878750,160822
SMI011-K04-B01-M02,0,2,Pf3D7_04_v3,188719,897099,708380
SMI011-K04-B01-M02,0,2,Pf3D7_04_v3,925583,1042880,117297
SMI011-K04-B01-M02,0,2,Pf3D7_06_v3,681253,833542,152289
SMI011-K04-B01-M02,0,2,Pf3D7_06_v3,1115191,1182560,67369
SMI011-K04-B01-M02,0,2,Pf3D7_06_v3,1287414,1294070,6656
SMI011-K04-B01-M02,0,2,Pf3D7_07_v3,77194,77965,771
SMI011-K04-B01-M02,0,2,Pf3D7_07_v3,981024,1326844,345820
SMI011-K04-B01-M02,0,2,Pf3D7_07_v3,1359829,1380526,20697
SMI011-K04-B01-M02,0,2,Pf3D7_08_v3,75691,1278610,1202919
SMI011-K04-B01-M02,0,2,Pf3D7_08_v3,1313796,1364499,50703
SMI011-K04-B01-M02,0,2,Pf3D7_09_v3,82153,416031,333878
SMI011-K04-B01-M02,0,2,Pf3D7_10_v3,74759,257324,182565
SMI011-K04-B01-M02,0,2,Pf3D7_10_v3,700215,1570149,869934
SMI011-K04-B01-M02,0,2,Pf3D7_11_v3,110641,1019067,908426
SMI011-K04-B01-M02,0,2,Pf3D7_12_v3,122749,382400,259651
SMI011-K04-B01-M02,0,2,Pf3D7_12_v3,418961,942525,523564
SMI011-K04-B01-M02,0,2,Pf3D7_12_v3,1281594,1341970,60376
SMI011-K04-B01-M02,0,2,Pf3D7_12_v3,1387200,2145373,758173
SMI011-K04-B01-M02,0,2,Pf3D7_13_v3,953193,2575636,1622443
SMI011-K04-B01-M02,0,2,Pf3D7_13_v3,2694451,2788579,94128
SMI011-K04-B01-M02,0,2,Pf3D7_14_v3,35796,40665,4869
SMI011-K04-B01-M02,0,2,Pf3D7_14_v3,407424,1380024,972600
SMI011-K04-B01-M02,0,2,Pf3D7_14_v3,2493622,2816765,323143
SMI011-K04-B01-M02,0,2,Pf3D7_14_v3,2886352,3124731,238379
SMI011-K04-B01-M02,0,2,Pf3D7_14_v3,3163741,3255607,91866
SMI011-K04-B01-M02,0,3,Pf3D7_01_v3,95518,567657,472139
SMI011-K04-B01-M02,0,3,Pf3D7_02_v3,109248,468251,359003
SMI011-K04-B01-M02,0,3,Pf3D7_02_v3,805840,862030,56190
SMI011-K04-B01-M02,0,3,Pf3D7_03_v3,71040,152653,81613
SMI011-K04-B01-M02,0,3,Pf3D7_03_v3,183105,878750,695645
SMI011-K04-B01-M02,0,3,Pf3D7_04_v3,188719,1143965,955246
SMI011-K04-B01-M02,0,3,Pf3D7_05_v3,39872,404998,365126
SMI011-K04-B01-M02,0,3,Pf3D7_05_v3,1038517,1119264,80747
SMI011-K04-B01-M02,0,3,Pf3D7_06_v3,681253,833542,152289
SMI011-K04-B01-M02,0,3,Pf3D7_06_v3,1115191,1182560,67369
SMI011-K04-B01-M02,0,3,Pf3D7_07_v3,609762,619957,10195
SMI011-K04-B01-M02,0,3,Pf3D7_08_v3,708827,1113495,404668
SMI011-K04-B01-M02,0,3,Pf3D7_08_v3,1313796,1363211,49415
SMI011-K04-B01-M02,0,3,Pf3D7_09_v3,416031,1472334,1056303
SMI011-K04-B01-M02,0,3,Pf3D7_10_v3,70764,169428,98664
SMI011-K04-B01-M02,0,3,Pf3D7_10_v3,1285388,1570149,284761
SMI011-K04-B01-M02,0,3,Pf3D7_11_v3,110641,778298,667657
SMI011-K04-B01-M02,0,3,Pf3D7_11_v3,796591,999375,202784
SMI011-K04-B01-M02,0,3,Pf3D7_11_v3,1019067,1126102,107035
SMI011-K04-B01-M02,0,3,Pf3D7_12_v3,122749,382400,259651
SMI011-K04-B01-M02,0,3,Pf3D7_12_v3,418961,942525,523564
SMI011-K04-B01-M02,0,3,Pf3D7_12_v3,1281594,1341970,60376
SMI011-K04-B01-M02,0,3,Pf3D7_12_v3,1387200,2145373,758173
SMI011-K04-B01-M02,0,3,Pf3D7_13_v3,953193,1237623,284430
SMI011-K04-B01-M02,0,3,Pf3D7_13_v3,2694451,2788579,94128
SMI011-K04-B01-M02,0,3,Pf3D7_14_v3,35796,40665,4869
SMI011-K04-B01-M02,0,3,Pf3D7_14_v3,407424,1380024,972600
SMI011-K04-B01-M02,0,3,Pf3D7_14_v3,1544403,1992946,448543
SMI011-K04-B01-M02,0,3,Pf3D7_14_v3,2020660,2886352,865692
SMI011-K04-B01-M02,0,3,Pf3D7_14_v3,3124731,3163741,39010
SMI011-K04-B01-M02,1,2,Pf3D7_01_v3,95518,163071,67553
SMI011-K04-B01-M02,1,2,Pf3D7_02_v3,614624,862030,247406
SMI011-K04-B01-M02,1,2,Pf3D7_03_v3,71040,183105,112065
SMI011-K04-B01-M02,1,2,Pf3D7_03_v3,510722,717928,207206
SMI011-K04-B01-M02,1,2,Pf3D7_03_v3,878750,1002946,124196
SMI011-K04-B01-M02,1,2,Pf3D7_04_v3,91817,188719,96902
SMI011-K04-B01-M02,1,2,Pf3D7_04_v3,255939,897099,641160
SMI011-K04-B01-M02,1,2,Pf3D7_05_v3,1263168,1321074,57906
SMI011-K04-B01-M02,1,2,Pf3D7_06_v3,74373,1287414,1213041
SMI011-K04-B01-M02,1,2,Pf3D7_07_v3,77965,477049,399084
SMI011-K04-B01-M02,1,2,Pf3D7_07_v3,477426,619957,142531
SMI011-K04-B01-M02,1,2,Pf3D7_07_v3,981024,1129144,148120
SMI011-K04-B01-M02,1,2,Pf3D7_07_v3,1359829,1380526,20697
SMI011-K04-B01-M02,1,2,Pf3D7_08_v3,75691,1364499,1288808
SMI011-K04-B01-M02,1,2,Pf3D7_09_v3,82153,1214930,1132777
SMI011-K04-B01-M02,1,2,Pf3D7_10_v3,257324,1254230,996906
SMI011-K04-B01-M02,1,2,Pf3D7_10_v3,1399091,1570149,171058
SMI011-K04-B01-M02,1,2,Pf3D7_11_v3,110641,778298,667657
SMI011-K04-B01-M02,1,2,Pf3D7_11_v3,796591,999375,202784
SMI011-K04-B01-M02,1,2,Pf3D7_11_v3,1293971,1295487,1516
SMI011-K04-B01-M02,1,2,Pf3D7_12_v3,382400,942525,560125
SMI011-K04-B01-M02,1,2,Pf3D7_12_v3,1670700,2155095,484395
SMI011-K04-B01-M02,1,2,Pf3D7_13_v3,77901,150114,72213
SMI011-K04-B01-M02,1,2,Pf3D7_13_v3,1155190,2575636,1420446
SMI011-K04-B01-M02,1,2,Pf3D7_13_v3,2694451,2788579,94128
SMI011-K04-B01-M02,1,2,Pf3D7_14_v3,35796,918720,882924
SMI011-K04-B01-M02,1,2,Pf3D7_14_v3,1992946,2020660,27714
SMI011-K04-B01-M02,1,2,Pf3D7_14_v3,2231863,2493622,261759
SMI011-K04-B01-M02,1,3,Pf3D7_01_v3,95518,567657,472139
SMI011-K04-B01-M02,1,3,Pf3D7_02_v3,109248,805840,696592
SMI011-K04-B01-M02,1,3,Pf3D7_03_v3,183105,510722,327617
SMI011-K04-B01-M02,1,3,Pf3D7_03_v3,878750,1002946,124196
SMI011-K04-B01-M02,1,3,Pf3D7_04_v3,91817,188719,96902
SMI011-K04-B01-M02,1,3,Pf3D7_04_v3,255939,925583,669644
SMI011-K04-B01-M02,1,3,Pf3D7_04_v3,1042880,1143965,101085
SMI011-K04-B01-M02,1,3,Pf3D7_05_v3,39872,404998,365126
SMI011-K04-B01-M02,1,3,Pf3D7_05_v3,1038517,1119264,80747
SMI011-K04-B01-M02,1,3,Pf3D7_05_v3,1263168,1321074,57906
SMI011-K04-B01-M02,1,3,Pf3D7_06_v3,74373,1294070,1219697
SMI011-K04-B01-M02,1,3,Pf3D7_07_v3,77194,477049,399855
SMI011-K04-B01-M02,1,3,Pf3D7_07_v3,477426,609762,132336
SMI011-K04-B01-M02,1,3,Pf3D7_07_v3,1129144,1326844,197700
SMI011-K04-B01-M02,1,3,Pf3D7_08_v3,708827,1113495,404668
SMI011-K04-B01-M02,1,3,Pf3D7_08_v3,1278610,1363211,84601
SMI011-K04-B01-M02,1,3,Pf3D7_09_v3,1214930,1472334,257404
SMI011-K04-B01-M02,1,3,Pf3D7_10_v3,70764,74759,3995
SMI011-K04-B01-M02,1,3,Pf3D7_10_v3,169428,700215,530787
SMI011-K04-B01-M02,1,3,Pf3D7_10_v3,1254230,1285388,31158
SMI011-K04-B01-M02,1,3,Pf3D7_10_v3,1399091,1570149,171058
SMI011-K04-B01-M02,1,3,Pf3D7_11_v3,110641,1126102,1015461
SMI011-K04-B01-M02,1,3,Pf3D7_11_v3,1293971,1295487,1516
SMI011-K04-B01-M02,1,3,Pf3D7_12_v3,382400,942525,560125
SMI011-K04-B01-M02,1,3,Pf3D7_12_v3,1670700,2155095,484395
SMI011-K04-B01-M02,1,3,Pf3D7_13_v3,77901,150114,72213
SMI011-K04-B01-M02,1,3,Pf3D7_13_v3,1155190,1237623,82433
SMI011-K04-B01-M02,1,3,Pf3D7_13_v3,2694451,2788579,94128
SMI011-K04-B01-M02,1,3,Pf3D7_14_v3,35796,918720,882924
SMI011-K04-B01-M02,1,3,Pf3D7_14_v3,1544403,2231863,687460
SMI011-K04-B01-M02,1,3,Pf3D7_14_v3,2816765,3255607,438842
SMI011-K04-B01-M02,2,3,Pf3D7_01_v3,95518,163071,67553
SMI011-K04-B01-M02,2,3,Pf3D7_02_v3,614624,805840,191216
SMI011-K04-B01-M02,2,3,Pf3D7_03_v3,717928,1002946,285018
SMI011-K04-B01-M02,2,3,Pf3D7_04_v3,91817,897099,805282
SMI011-K04-B01-M02,2,3,Pf3D7_04_v3,925583,1042880,117297
SMI011-K04-B01-M02,2,3,Pf3D7_05_v3,404998,1038517,633519
SMI011-K04-B01-M02,2,3,Pf3D7_05_v3,1119264,1321074,201810
SMI011-K04-B01-M02,2,3,Pf3D7_06_v3,74373,1287414,1213041
SMI011-K04-B01-M02,2,3,Pf3D7_07_v3,77965,609762,531797
SMI011-K04-B01-M02,2,3,Pf3D7_07_v3,619957,981024,361067
SMI011-K04-B01-M02,2,3,Pf3D7_07_v3,1326844,1359829,32985
SMI011-K04-B01-M02,2,3,Pf3D7_08_v3,708827,1113495,404668
SMI011-K04-B01-M02,2,3,Pf3D7_08_v3,1278610,1363211,84601
SMI011-K04-B01-M02,2,3,Pf3D7_10_v3,74759,169428,94669
SMI011-K04-B01-M02,2,3,Pf3D7_10_v3,257324,700215,442891
SMI011-K04-B01-M02,2,3,Pf3D7_10_v3,1285388,1570149,284761
SMI011-K04-B01-M02,2,3,Pf3D7_11_v3,110641,778298,667657
SMI011-K04-B01-M02,2,3,Pf3D7_11_v3,796591,999375,202784
SMI011-K04-B01-M02,2,3,Pf3D7_11_v3,1126102,2003008,876906
SMI011-K04-B01-M02,2,3,Pf3D7_12_v3,61435,2155095,2093660
SMI011-K04-B01-M02,2,3,Pf3D7_13_v3,77901,1237623,1159722
SMI011-K04-B01-M02,2,3,Pf3D7_13_v3,2575636,2788579,212943
SMI011-K04-B01-M02,2,3,Pf3D7_14_v3,35796,1544403,1508607
SMI011-K04-B01-M02,2,3,Pf3D7_14_v3,1992946,2020660,27714
SMI011-K04-B01-M02,2,3,Pf3D7_14_v3,2493622,2816765,323143
SMI013-K04-B02-M01,0,1,Pf3D7_01_v3,107823,567657,459834
SMI013-K04-B02-M01,0,1,Pf3D7_02_v3,109248,213574,104326
SMI013-K04-B02-M01,0,1,Pf3D7_02_v3,855754,862030,6276
SMI013-K04-B02-M01,0,1,Pf3D7_03_v3,71040,205816,134776
SMI013-K04-B02-M01,0,1,Pf3D7_03_v3,926595,1002946,76351
SMI013-K04-B02-M01,0,1,Pf3D7_04_v3,91817,147659,55842
SMI013-K04-B02-M01,0,1,Pf3D7_04_v3,255939,420218,164279
SMI013-K04-B02-M01,0,1,Pf3D7_04_v3,911002,999012,88010
SMI013-K04-B02-M01,0,1,Pf3D7_05_v3,329613,450949,121336
SMI013-K04-B02-M01,0,1,Pf3D7_05_v3,1239637,1321074,81437
SMI013-K04-B02-M01,0,1,Pf3D7_06_v3,74373,532206,457833
SMI013-K04-B02-M01,0,1,Pf3D7_06_v3,532920,824200,291280
SMI013-K04-B02-M01,0,1,Pf3D7_06_v3,847157,1111651,264494
SMI013-K04-B02-M01,0,1,Pf3D7_06_v3,1288229,1294070,5841
SMI013-K04-B02-M01,0,1,Pf3D7_07_v3,77194,132959,55765
SMI013-K04-B02-M01,0,1,Pf3D7_07_v3,450424,1326844,876420
SMI013-K04-B02-M01,0,1,Pf3D7_08_v3,407080,468669,61589
SMI013-K04-B02-M01,0,1,Pf3D7_08_v3,812418,1278610,466192
SMI013-K04-B02-M01,0,1,Pf3D7_09_v3,158728,182189,23461
SMI013-K04-B02-M01,0,1,Pf3D7_09_v3,512326,1472334,960008
SMI013-K04-B02-M01,0,1,Pf3D7_10_v3,70764,1074462,1003698
SMI013-K04-B02-M01,0,1,Pf3D7_10_v3,1254230,1389266,135036
SMI013-K04-B02-M01,0,1,Pf3D7_11_v3,1634558,1991090,356532
SMI013-K04-B02-M01,0,1,Pf3D7_11_v3,1995514,1997885,2371
SMI013-K04-B02-M01,0,1,Pf3D7_12_v3,434725,762514,327789
SMI013-K04-B02-M01,0,1,Pf3D7_12_v3,1670700,2155095,484395
SMI013-K04-B02-M01,0,1,Pf3D7_13_v3,77901,95119,17218
SMI013-K04-B02-M01,0,1,Pf3D7_13_v3,2575636,2788579,212943
SMI013-K04-B02-M01,0,1,Pf3D7_14_v3,35796,407424,371628
SMI013-K04-B02-M01,0,1,Pf3D7_14_v3,1396018,1854863,458845
SMI013-K04-B02-M01,0,1,Pf3D7_14_v3,2231863,3255607,1023744
SMI013-K04-B02-M01,0,1,Pf3D7_01_v3,95518,167312,71794
SMI013-K04-B02-M01,0,1,Pf3D7_03_v3,855002,1002946,147944
SMI013-K04-B02-M01,0,1,Pf3D7_04_v3,91817,255939,164122
SMI013-K04-B02-M01,0,1,Pf3D7_04_v3,1141085,1143965,2880
SMI013-K04-B02-M01,0,1,Pf3D7_05_v3,39872,476050,436178
SMI013-K04-B02-M01,0,1,Pf3D7_05_v3,1289061,1316525,27464
SMI013-K04-B02-M01,0,1,Pf3D7_06_v3,315733,1111651,795918
SMI013-K04-B02-M01,0,1,Pf3D7_07_v3,257865,344469,86604
SMI013-K04-B02-M01,0,1,Pf3D7_07_v3,481362,619957,138595
SMI013-K04-B02-M01,0,1,Pf3D7_07_v3,620279,1171997,551718
SMI013-K04-B02-M01,0,1,Pf3D7_08_v3,98362,292740,194378
SMI013-K04-B02-M01,0,1,Pf3D7_10_v3,188681,574773,386092
SMI013-K04-B02-M01,0,1,Pf3D7_10_v3,1017736,1254230,236494
SMI013-K04-B02-M01,0,1,Pf3D7_11_v3,467712,683965,216253
SMI013-K04-B02-M01,0,1,Pf3D7_11_v3,1114208,1294584,180376
SMI013-K04-B02-M01,0,1,Pf3D7_13_v3,156176,2575636,2419460
SMI013-K04-B02-M01,0,1,Pf3D7_14_v3,185202,1467935,1282733
SMI016-K04-B02-M02,0,1,Pf3D7_01_v3,95518,528425,432907
SMI016-K04-B02-M02,0,1,Pf3D7_02_v3,200552,862030,661478
SMI016-K04-B02-M02,0,1,Pf3D7_03_v3,71040,71291,251
SMI016-K04-B02-M02,0,1,Pf3D7_03_v3,363629,703924,340295
SMI016-K04-B02-M02,0,1,Pf3D7_03_v3,878750,1002946,124196
SMI016-K04-B02-M02,0,1,Pf3D7_04_v3,91817,1143965,1052148
SMI016-K04-B02-M02,0,1,Pf3D7_05_v3,39872,288859,248987
SMI016-K04-B02-M02,0,1,Pf3D7_05_v3,364200,1114074,749874
SMI016-K04-B02-M02,0,1,Pf3D7_06_v3,824787,1111651,286864
SMI016-K04-B02-M02,0,1,Pf3D7_07_v3,472858,1345508,872650
SMI016-K04-B02-M02,0,1,Pf3D7_08_v3,102094,1113495,1011401
SMI016-K04-B02-M02,0,1,Pf3D7_08_v3,1178845,1275058,96213
SMI016-K04-B02-M02,0,1,Pf3D7_09_v3,158528,165871,7343
SMI016-K04-B02-M02,0,1,Pf3D7_09_v3,416031,1472334,1056303
SMI016-K04-B02-M02,0,1,Pf3D7_10_v3,70764,562016,491252
SMI016-K04-B02-M02,0,1,Pf3D7_10_v3,661961,700215,38254
SMI016-K04-B02-M02,0,1,Pf3D7_10_v3,1254230,1570149,315919
SMI016-K04-B02-M02,0,1,Pf3D7_11_v3,110641,247541,136900
SMI016-K04-B02-M02,0,1,Pf3D7_11_v3,1006055,1209400,203345
SMI016-K04-B02-M02,0,1,Pf3D7_11_v3,1294584,2003008,708424
SMI016-K04-B02-M02,0,1,Pf3D7_12_v3,61435,122749,61314
SMI016-K04-B02-M02,0,1,Pf3D7_12_v3,350796,624506,273710
SMI016-K04-B02-M02,0,1,Pf3D7_12_v3,1380967,1670700,289733
SMI016-K04-B02-M02,0,1,Pf3D7_13_v3,476274,2788579,2312305
SMI016-K04-B02-M02,0,1,Pf3D7_14_v3,35796,259286,223490
SMI016-K04-B02-M02,0,1,Pf3D7_14_v3,334976,393389,58413
SMI016-K04-B02-M02,0,1,Pf3D7_14_v3,1209838,1393032,183194
SMI016-K04-B02-M02,0,1,Pf3D7_01_v3,95518,567657,472139
SMI016-K04-B02-M02,0,1,Pf3D7_02_v3,109248,278236,168988
SMI016-K04-B02-M02,0,1,Pf3D7_02_v3,405079,480927,75848
SMI016-K04-B02-M02,0,1,Pf3D7_02_v3,805840,862030,56190
SMI016-K04-B02-M02,0,1,Pf3D7_03_v3,71040,79845,8805
SMI016-K04-B02-M02,0,1,Pf3D7_03_v3,285065,1002946,717881
SMI016-K04-B02-M02,0,1,Pf3D7_04_v3,91817,255939,164122
SMI016-K04-B02-M02,0,1,Pf3D7_04_v3,293588,426436,132848
SMI016-K04-B02-M02,0,1,Pf3D7_04_v3,428626,1143965,715339
SMI016-K04-B02-M02,0,1,Pf3D7_05_v3,39872,1321074,1281202
SMI016-K04-B02-M02,0,1,Pf3D7_06_v3,74373,1294070,1219697
SMI016-K04-B02-M02,0,1,Pf3D7_07_v3,77194,80194,3000
SMI016-K04-B02-M02,0,1,Pf3D7_07_v3,278066,449901,171835
SMI016-K04-B02-M02,0,1,Pf3D7_07_v3,480458,496692,16234
SMI016-K04-B02-M02,0,1,Pf3D7_07_v3,619957,1380526,760569
SMI016-K04-B02-M02,0,1,Pf3D7_08_v3,75691,845787,770096
SMI016-K04-B02-M02,0,1,Pf3D7_08_v3,920130,1278610,358480
SMI016-K04-B02-M02,0,1,Pf3D7_09_v3,416031,926696,510665
SMI016-K04-B02-M02,0,1,Pf3D7_10_v3,1171192,1254230,83038
SMI016-K04-B02-M02,0,1,Pf3D7_10_v3,1319002,1384940,65938
SMI016-K04-B02-M02,0,1,Pf3D7_11_v3,120802,1294741,1173939
SMI016-K04-B02-M02,0,1,Pf3D7_12_v3,122749,382400,259651
SMI016-K04-B02-M02,0,1,Pf3D7_12_v3,817686,892971,75285
SMI016-K04-B02-M02,0,1,Pf3D7_12_v3,902351,2155095,1252744
SMI016-K04-B02-M02,0,1,Pf3D7_13_v3,77901,2422801,2344900
SMI016-K04-B02-M02,0,1,Pf3D7_13_v3,2575636,2788579,212943
SMI016-K04-B02-M02,0,1,Pf3D7_14_v3,35796,1852794,1816998
SMI016-K04-B02-M02,0,1,Pf3D7_14_v3,2128849,2451029,322180
SMI016-K04-B02-M02,0,1,Pf3D7_14_v3,3126510,3255607,129097
SMI017-K04-B02-M03,0,1,Pf3D7_01_v3,95518,567657,472139
SMI017-K04-B02-M03,0,1,Pf3D7_02_v3,109248,862030,752782
SMI017-K04-B02-M03,0,1,Pf3D7_03_v3,71040,79845,8805
SMI017-K04-B02-M03,0,1,Pf3D7_03_v3,183105,351999,168894
SMI017-K04-B02-M03,0,1,Pf3D7_03_v3,717928,1002946,285018
SMI017-K04-B02-M03,0,1,Pf3D7_04_v3,91817,241099,149282
SMI017-K04-B02-M03,0,1,Pf3D7_04_v3,255939,528936,272997
SMI017-K04-B02-M03,0,1,Pf3D7_04_v3,667269,918934,251665
SMI017-K04-B02-M03,0,1,Pf3D7_04_v3,1100339,1143965,43626
SMI017-K04-B02-M03,0,1,Pf3D7_05_v3,39872,326264,286392
SMI017-K04-B02-M03,0,1,Pf3D7_05_v3,383150,1321074,937924
SMI017-K04-B02-M03,0,1,Pf3D7_06_v3,74373,240510,166137
SMI017-K04-B02-M03,0,1,Pf3D7_06_v3,542924,796597,253673
SMI017-K04-B02-M03,0,1,Pf3D7_06_v3,824200,1111651,287451
SMI017-K04-B02-M03,0,1,Pf3D7_06_v3,1252136,1272170,20034
SMI017-K04-B02-M03,0,1,Pf3D7_07_v3,456262,1170354,714092
SMI017-K04-B02-M03,0,1,Pf3D7_07_v3,1171997,1354996,182999
SMI017-K04-B02-M03,0,1,Pf3D7_07_v3,1380223,1380526,303
SMI017-K04-B02-M03,0,1,Pf3D7_08_v3,75691,509018,433327
SMI017-K04-B02-M03,0,1,Pf3D7_08_v3,527402,674002,146600
SMI017-K04-B02-M03,0,1,Pf3D7_08_v3,942040,1278610,336570
SMI017-K04-B02-M03,0,1,Pf3D7_09_v3,241198,1472334,1231136
SMI017-K04-B02-M03,0,1,Pf3D7_10_v3,70764,75884,5120
SMI017-K04-B02-M03,0,1,Pf3D7_10_v3,113505,286669,173164
SMI017-K04-B02-M03,0,1,Pf3D7_10_v3,483740,537544,53804
SMI017-K04-B02-M03,0,1,Pf3D7_10_v3,658468,1172712,514244
SMI017-K04-B02-M03,0,1,Pf3D7_10_v3,1254230,1432783,178553
SMI017-K04-B02-M03,0,1,Pf3D7_11_v3,468283,865260,396977
SMI017-K04-B02-M03,0,1,Pf3D7_11_v3,1038134,1346703,308569
SMI017-K04-B02-M03,0,1,Pf3D7_11_v3,1419868,2003008,583140
SMI017-K04-B02-M03,0,1,Pf3D7_12_v3,61435,817686,756251
SMI017-K04-B02-M03,0,1,Pf3D7_12_v3,1427424,2155095,727671
SMI017-K04-B02-M03,0,1,Pf3D7_13_v3,77901,106161,28260
SMI017-K04-B02-M03,0,1,Pf3D7_13_v3,1155190,2575636,1420446
SMI017-K04-B02-M03,0,1,Pf3D7_13_v3,2598863,2788579,189716
SMI017-K04-B02-M03,0,1,Pf3D7_14_v3,35796,407424,371628
SMI017-K04-B02-M03,0,1,Pf3D7_14_v3,480428,699548,219120
SMI017-K04-B02-M03,0,1,Pf3D7_14_v3,1010059,1380024,369965
SMI017-K04-B02-M03,0,1,Pf3D7_14_v3,1598512,1819017,220505
SMI017-K04-B02-M03,0,1,Pf3D7_14_v3,2451029,3255607,804578
SMI017-K04-B02-M03,0,2,Pf3D7_01_v3,95518,145227,49709
SMI017-K04-B02-M03,0,2,Pf3D7_01_v3,500312,567657,67345
SMI017-K04-B02-M03,0,2,Pf3D7_02_v3,109248,862030,752782
SMI017-K04-B02-M03,0,2,Pf3D7_03_v3,71040,79845,8805
SMI017-K04-B02-M03,0,2,Pf3D7_03_v3,660596,1002946,342350
SMI017-K04-B02-M03,0,2,Pf3D7_04_v3,91817,667269,575452
SMI017-K04-B02-M03,0,2,Pf3D7_04_v3,860462,1143965,283503
SMI017-K04-B02-M03,0,2,Pf3D7_05_v3,39872,329613,289741
SMI017-K04-B02-M03,0,2,Pf3D7_05_v3,383150,1321074,937924
SMI017-K04-B02-M03,0,2,Pf3D7_06_v3,74373,240510,166137
SMI017-K04-B02-M03,0,2,Pf3D7_06_v3,542924,796597,253673
SMI017-K04-B02-M03,0,2,Pf3D7_06_v3,1111651,1294070,182419
SMI017-K04-B02-M03,0,2,Pf3D7_07_v3,77194,480458,403264
SMI017-K04-B02-M03,0,2,Pf3D7_07_v3,635759,674338,38579
SMI017-K04-B02-M03,0,2,Pf3D7_07_v3,1170354,1380223,209869
SMI017-K04-B02-M03,0,2,Pf3D7_08_v3,332377,942040,609663
SMI017-K04-B02-M03,0,2,Pf3D7_08_v3,1113495,1214394,100899
SMI017-K04-B02-M03,0,2,Pf3D7_09_v3,837879,1472334,634455
SMI017-K04-B02-M03,0,2,Pf3D7_10_v3,70764,113505,42741
SMI017-K04-B02-M03,0,2,Pf3D7_10_v3,286669,483740,197071
SMI017-K04-B02-M03,0,2,Pf3D7_10_v3,537544,1254230,716686
SMI017-K04-B02-M03,0,2,Pf3D7_10_v3,1326422,1432783,106361
SMI017-K04-B02-M03,0,2,Pf3D7_11_v3,865260,1038134,172874
SMI017-K04-B02-M03,0,2,Pf3D7_11_v3,1294584,1986200,691616
SMI017-K04-B02-M03,0,2,Pf3D7_11_v3,1996326,2003008,6682
SMI017-K04-B02-M03,0,2,Pf3D7_12_v3,61435,122749,61314
SMI017-K04-B02-M03,0,2,Pf3D7_12_v3,382400,2155095,1772695
SMI017-K04-B02-M03,0,2,Pf3D7_13_v3,77901,106161,28260
SMI017-K04-B02-M03,0,2,Pf3D7_13_v3,270924,1155190,884266
SMI017-K04-B02-M03,0,2,Pf3D7_13_v3,1891015,2304158,413143
SMI017-K04-B02-M03,0,2,Pf3D7_13_v3,2575636,2788579,212943
SMI017-K04-B02-M03,0,2,Pf3D7_14_v3,35796,918720,882924
SMI017-K04-B02-M03,0,2,Pf3D7_14_v3,1010059,3255607,2245548
SMI017-K04-B02-M03,1,2,Pf3D7_01_v3,95518,145227,49709
SMI017-K04-B02-M03,1,2,Pf3D7_01_v3,500312,567657,67345
SMI017-K04-B02-M03,1,2,Pf3D7_02_v3,109248,862030,752782
SMI017-K04-B02-M03,1,2,Pf3D7_03_v3,71040,183105,112065
SMI017-K04-B02-M03,1,2,Pf3D7_03_v3,351999,660596,308597
SMI017-K04-B02-M03,1,2,Pf3D7_03_v3,717928,1002946,285018
SMI017-K04-B02-M03,1,2,Pf3D7_04_v3,91817,241099,149282
SMI017-K04-B02-M03,1,2,Pf3D7_04_v3,255939,528936,272997
SMI017-K04-B02-M03,1,2,Pf3D7_04_v3,860462,918934,58472
SMI017-K04-B02-M03,1,2,Pf3D7_04_v3,1100339,1143965,43626
SMI017-K04-B02-M03,1,2,Pf3D7_05_v3,39872,326264,286392
SMI017-K04-B02-M03,1,2,Pf3D7_05_v3,329613,1321074,991461
SMI017-K04-B02-M03,1,2,Pf3D7_06_v3,74373,824200,749827
SMI017-K04-B02-M03,1,2,Pf3D7_06_v3,1252136,1272170,20034
SMI017-K04-B02-M03,1,2,Pf3D7_07_v3,456262,480458,24196
SMI017-K04-B02-M03,1,2,Pf3D7_07_v3,635759,674338,38579
SMI017-K04-B02-M03,1,2,Pf3D7_07_v3,1171997,1354996,182999
SMI017-K04-B02-M03,1,2,Pf3D7_08_v3,332377,509018,176641
SMI017-K04-B02-M03,1,2,Pf3D7_08_v3,527402,674002,146600
SMI017-K04-B02-M03,1,2,Pf3D7_08_v3,1113495,1214394,100899
SMI017-K04-B02-M03,1,2,Pf3D7_08_v3,1278610,1364499,85889
SMI017-K04-B02-M03,1,2,Pf3D7_09_v3,82153,241198,159045
SMI017-K04-B02-M03,1,2,Pf3D7_09_v3,837879,1472334,634455
SMI017-K04-B02-M03,1,2,Pf3D7_10_v3,70764,75884,5120
SMI017-K04-B02-M03,1,2,Pf3D7_10_v3,658468,1172712,514244
SMI017-K04-B02-M03,1,2,Pf3D7_10_v3,1326422,1570149,243727
SMI017-K04-B02-M03,1,2,Pf3D7_11_v3,110641,468283,357642
SMI017-K04-B02-M03,1,2,Pf3D7_11_v3,1294584,1346703,52119
SMI017-K04-B02-M03,1,2,Pf3D7_11_v3,1419868,1986200,566332
SMI017-K04-B02-M03,1,2,Pf3D7_11_v3,1996326,2003008,6682
SMI017-K04-B02-M03,1,2,Pf3D7_12_v3,61435,122749,61314
SMI017-K04-B02-M03,1,2,Pf3D7_12_v3,382400,817686,435286
SMI017-K04-B02-M03,1,2,Pf3D7_12_v3,1427424,2155095,727671
SMI017-K04-B02-M03,1,2,Pf3D7_13_v3,77901,270924,193023
SMI017-K04-B02-M03,1,2,Pf3D7_13_v3,1891015,2304158,413143
SMI017-K04-B02-M03,1,2,Pf3D7_13_v3,2598863,2788579,189716
SMI017-K04-B02-M03,1,2,Pf3D7_14_v3,35796,407424,371628
SMI017-K04-B02-M03,1,2,Pf3D7_14_v3,480428,699548,219120
SMI017-K04-B02-M03,1,2,Pf3D7_14_v3,918720,1380024,461304
SMI017-K04-B02-M03,1,2,Pf3D7_14_v3,1598512,1819017,220505
SMI017-K04-B02-M03,1,2,Pf3D7_14_v3,2451029,3255607,804578
SMI018-K04-B02-M03,0,1,Pf3D7_01_v3,95518,567657,472139
SMI018-K04-B02-M03,0,1,Pf3D7_02_v3,109248,862030,752782
SMI018-K04-B02-M03,0,1,Pf3D7_03_v3,71040,886200,815160
SMI018-K04-B02-M03,0,1,Pf3D7_04_v3,132645,415353,282708
SMI018-K04-B02-M03,0,1,Pf3D7_04_v3,803561,812994,9433
SMI018-K04-B02-M03,0,1,Pf3D7_04_v3,881197,1143965,262768
SMI018-K04-B02-M03,0,1,Pf3D7_05_v3,39872,507871,467999
SMI018-K04-B02-M03,0,1,Pf3D7_05_v3,921466,937121,15655
SMI018-K04-B02-M03,0,1,Pf3D7_05_v3,1038517,1166914,128397
SMI018-K04-B02-M03,0,1,Pf3D7_05_v3,1271257,1289114,17857
SMI018-K04-B02-M03,0,1,Pf3D7_05_v3,1316719,1321074,4355
SMI018-K04-B02-M03,0,1,Pf3D7_06_v3,74373,685943,611570
SMI018-K04-B02-M03,0,1,Pf3D7_06_v3,796597,1294070,497473
SMI018-K04-B02-M03,0,1,Pf3D7_07_v3,77194,1380526,1303332
SMI018-K04-B02-M03,0,1,Pf3D7_08_v3,75691,119204,43513
SMI018-K04-B02-M03,0,1,Pf3D7_08_v3,509018,1113495,604477
SMI018-K04-B02-M03,0,1,Pf3D7_08_v3,1225428,1364499,139071
SMI018-K04-B02-M03,0,1,Pf3D7_09_v3,82153,1206885,1124732
SMI018-K04-B02-M03,0,1,Pf3D7_10_v3,190030,538449,348419
SMI018-K04-B02-M03,0,1,Pf3D7_10_v3,694878,957224,262346
SMI018-K04-B02-M03,0,1,Pf3D7_10_v3,1254230,1570149,315919
SMI018-K04-B02-M03,0,1,Pf3D7_11_v3,110641,2003008,1892367
SMI018-K04-B02-M03,0,1,Pf3D7_12_v3,61435,569352,507917
SMI018-K04-B02-M03,0,1,Pf3D7_12_v3,807679,1670700,863021
SMI018-K04-B02-M03,0,1,Pf3D7_13_v3,106161,2788579,2682418
SMI018-K04-B02-M03,0,1,Pf3D7_14_v3,35796,1656678,1620882
SMI018-K04-B02-M03,0,1,Pf3D7_14_v3,1864313,3255607,1391294
SMI018-K04-B02-M03,0,2,Pf3D7_01_v3,95518,567657,472139
SMI018-K04-B02-M03,0,2,Pf3D7_02_v3,109248,862030,752782
SMI018-K04-B02-M03,0,2,Pf3D7_03_v3,71040,886200,815160
SMI018-K04-B02-M03,0,2,Pf3D7_04_v3,132645,415353,282708
SMI018-K04-B02-M03,0,2,Pf3D7_04_v3,415693,1143965,728272
SMI018-K04-B02-M03,0,2,Pf3D7_05_v3,39872,383150,343278
SMI018-K04-B02-M03,0,2,Pf3D7_05_v3,507871,1038517,530646
SMI018-K04-B02-M03,0,2,Pf3D7_05_v3,1271257,1289114,17857
SMI018-K04-B02-M03,0,2,Pf3D7_05_v3,1316719,1321074,4355
SMI018-K04-B02-M03,0,2,Pf3D7_06_v3,74373,685943,611570
SMI018-K04-B02-M03,0,2,Pf3D7_06_v3,796597,1294070,497473
SMI018-K04-B02-M03,0,2,Pf3D7_07_v3,77194,468540,391346
SMI018-K04-B02-M03,0,2,Pf3D7_07_v3,477049,480458,3409
SMI018-K04-B02-M03,0,2,Pf3D7_07_v3,492639,610398,117759
SMI018-K04-B02-M03,0,2,Pf3D7_07_v3,618007,1256331,638324
SMI018-K04-B02-M03,0,2,Pf3D7_08_v3,119204,1364499,1245295
SMI018-K04-B02-M03,0,2,Pf3D7_09_v3,82153,1472334,1390181
SMI018-K04-B02-M03,0,2,Pf3D7_10_v3,70764,190030,119266
SMI018-K04-B02-M03,0,2,Pf3D7_10_v3,538449,1570149,1031700
SMI018-K04-B02-M03,0,2,Pf3D7_11_v3,110641,370037,259396
SMI018-K04-B02-M03,0,2,Pf3D7_11_v3,778298,1294584,516286
SMI018-K04-B02-M03,0,2,Pf3D7_11_v3,1543806,2003008,459202
SMI018-K04-B02-M03,0,2,Pf3D7_12_v3,61435,807679,746244
SMI018-K04-B02-M03,0,2,Pf3D7_12_v3,1918752,2155095,236343
SMI018-K04-B02-M03,0,2,Pf3D7_13_v3,77901,1891015,1813114
SMI018-K04-B02-M03,0,2,Pf3D7_13_v3,2415386,2788579,373193
SMI018-K04-B02-M03,0,2,Pf3D7_14_v3,35796,407424,371628
SMI018-K04-B02-M03,0,2,Pf3D7_14_v3,918720,1232619,313899
SMI018-K04-B02-M03,0,2,Pf3D7_14_v3,1864313,3255607,1391294
SMI018-K04-B02-M03,1,2,Pf3D7_01_v3,95518,567657,472139
SMI018-K04-B02-M03,1,2,Pf3D7_02_v3,109248,862030,752782
SMI018-K04-B02-M03,1,2,Pf3D7_03_v3,71040,1002946,931906
SMI018-K04-B02-M03,1,2,Pf3D7_04_v3,91817,415693,323876
SMI018-K04-B02-M03,1,2,Pf3D7_04_v3,803561,812994,9433
SMI018-K04-B02-M03,1,2,Pf3D7_04_v3,881197,1143965,262768
SMI018-K04-B02-M03,1,2,Pf3D7_05_v3,39872,383150,343278
SMI018-K04-B02-M03,1,2,Pf3D7_05_v3,921466,937121,15655
SMI018-K04-B02-M03,1,2,Pf3D7_05_v3,1166914,1321074,154160
SMI018-K04-B02-M03,1,2,Pf3D7_06_v3,74373,1294070,1219697
SMI018-K04-B02-M03,1,2,Pf3D7_07_v3,77194,468540,391346
SMI018-K04-B02-M03,1,2,Pf3D7_07_v3,477049,480458,3409
SMI018-K04-B02-M03,1,2,Pf3D7_07_v3,492639,610398,117759
SMI018-K04-B02-M03,1,2,Pf3D7_07_v3,618007,1256331,638324
SMI018-K04-B02-M03,1,2,Pf3D7_08_v3,509018,1113495,604477
SMI018-K04-B02-M03,1,2,Pf3D7_08_v3,1225428,1364499,139071
SMI018-K04-B02-M03,1,2,Pf3D7_09_v3,82153,1206885,1124732
SMI018-K04-B02-M03,1,2,Pf3D7_10_v3,694878,957224,262346
SMI018-K04-B02-M03,1,2,Pf3D7_10_v3,1254230,1570149,315919
SMI018-K04-B02-M03,1,2,Pf3D7_11_v3,110641,370037,259396
SMI018-K04-B02-M03,1,2,Pf3D7_11_v3,778298,1294584,516286
SMI018-K04-B02-M03,1,2,Pf3D7_11_v3,1543806,2003008,459202
SMI018-K04-B02-M03,1,2,Pf3D7_12_v3,61435,569352,507917
SMI018-K04-B02-M03,1,2,Pf3D7_12_v3,1670700,1918752,248052
SMI018-K04-B02-M03,1,2,Pf3D7_13_v3,106161,1891015,1784854
SMI018-K04-B02-M03,1,2,Pf3D7_13_v3,2415386,2788579,373193
SMI018-K04-B02-M03,1,2,Pf3D7_14_v3,35796,407424,371628
SMI018-K04-B02-M03,1,2,Pf3D7_14_v3,918720,1232619,313899
SMI018-K04-B02-M03,1,2,Pf3D7_14_v3,1656678,3255607,1598929
SMI019-K04-B03-M03,0,1,Pf3D7_01_v3,512936,567657,54721
SMI019-K04-B03-M03,0,1,Pf3D7_02_v3,109248,862030,752782
SMI019-K04-B03-M03,0,1,Pf3D7_03_v3,71040,1002946,931906
SMI019-K04-B03-M03,0,1,Pf3D7_04_v3,91817,537511,445694
SMI019-K04-B03-M03,0,1,Pf3D7_04_v3,655877,792225,136348
SMI019-K04-B03-M03,0,1,Pf3D7_04_v3,831954,860538,28584
SMI019-K04-B03-M03,0,1,Pf3D7_04_v3,881382,1143965,262583
SMI019-K04-B03-M03,0,1,Pf3D7_05_v3,39872,1321074,1281202
SMI019-K04-B03-M03,0,1,Pf3D7_06_v3,74373,593826,519453
SMI019-K04-B03-M03,0,1,Pf3D7_06_v3,624118,1294070,669952
SMI019-K04-B03-M03,0,1,Pf3D7_07_v3,77194,1380526,1303332
SMI019-K04-B03-M03,0,1,Pf3D7_08_v3,75691,405667,329976
SMI019-K04-B03-M03,0,1,Pf3D7_08_v3,509018,806841,297823
SMI019-K04-B03-M03,0,1,Pf3D7_08_v3,1113495,1304652,191157
SMI019-K04-B03-M03,0,1,Pf3D7_08_v3,1318079,1364499,46420
SMI019-K04-B03-M03,0,1,Pf3D7_09_v3,82153,416031,333878
SMI019-K04-B03-M03,0,1,Pf3D7_10_v3,185257,638636,453379
SMI019-K04-B03-M03,0,1,Pf3D7_10_v3,764091,1254230,490139
SMI019-K04-B03-M03,0,1,Pf3D7_10_v3,1325948,1570149,244201
SMI019-K04-B03-M03,0,1,Pf3D7_11_v3,110641,292976,182335
SMI019-K04-B03-M03,0,1,Pf3D7_11_v3,360271,807246,446975
SMI019-K04-B03-M03,0,1,Pf3D7_11_v3,1084422,1745907,661485
SMI019-K04-B03-M03,0,1,Pf3D7_11_v3,1749819,2003008,253189
SMI019-K04-B03-M03,0,1,Pf3D7_12_v3,61435,2155095,2093660
SMI019-K04-B03-M03,0,1,Pf3D7_13_v3,77901,1512247,1434346
SMI019-K04-B03-M03,0,1,Pf3D7_13_v3,1565364,1891015,325651
SMI019-K04-B03-M03,0,1,Pf3D7_13_v3,2063107,2304158,241051
SMI019-K04-B03-M03,0,1,Pf3D7_13_v3,2422766,2788579,365813
SMI019-K04-B03-M03,0,1,Pf3D7_14_v3,35796,699548,663752
SMI019-K04-B03-M03,0,1,Pf3D7_14_v3,918720,1454960,536240
SMI019-K04-B03-M03,0,1,Pf3D7_14_v3,1669666,1819017,149351
SMI019-K04-B03-M03,0,1,Pf3D7_14_v3,2006084,2020795,14711
SMI019-K04-B03-M03,0,1,Pf3D7_14_v3,2231863,3255607,1023744
SMI020-K04-B02-M03,0,1,Pf3D7_01_v3,95518,567657,472139
SMI020-K04-B02-M03,0,1,Pf3D7_02_v3,109248,468251,359003
SMI020-K04-B02-M03,0,1,Pf3D7_02_v3,805840,862030,56190
SMI020-K04-B02-M03,0,1,Pf3D7_03_v3,71040,1002946,931906
SMI020-K04-B02-M03,0,1,Pf3D7_04_v3,91817,999012,907195
SMI020-K04-B02-M03,0,1,Pf3D7_04_v3,1100339,1143965,43626
SMI020-K04-B02-M03,0,1,Pf3D7_05_v3,39872,216203,176331
SMI020-K04-B02-M03,0,1,Pf3D7_05_v3,383150,1321074,937924
SMI020-K04-B02-M03,0,1,Pf3D7_06_v3,74373,796597,722224
SMI020-K04-B02-M03,0,1,Pf3D7_06_v3,1111651,1294070,182419
SMI020-K04-B02-M03,0,1,Pf3D7_07_v3,77194,79935,2741
SMI020-K04-B02-M03,0,1,Pf3D7_07_v3,82983,480458,397475
SMI020-K04-B02-M03,0,1,Pf3D7_07_v3,619957,1309887,689930
SMI020-K04-B02-M03,0,1,Pf3D7_07_v3,1318984,1380526,61542
SMI020-K04-B02-M03,0,1,Pf3D7_08_v3,75691,1239302,1163611
SMI020-K04-B02-M03,0,1,Pf3D7_08_v3,1278610,1364499,85889
SMI020-K04-B02-M03,0,1,Pf3D7_09_v3,82153,1472334,1390181
SMI020-K04-B02-M03,0,1,Pf3D7_10_v3,70764,638636,567872
SMI020-K04-B02-M03,0,1,Pf3D7_10_v3,912627,1570149,657522
SMI020-K04-B02-M03,0,1,Pf3D7_11_v3,110641,1419868,1309227
SMI020-K04-B02-M03,0,1,Pf3D7_11_v3,1447089,2003008,555919
SMI020-K04-B02-M03,0,1,Pf3D7_12_v3,61435,2155095,2093660
SMI020-K04-B02-M03,0,1,Pf3D7_13_v3,77901,2788579,2710678
SMI020-K04-B02-M03,0,1,Pf3D7_14_v3,35796,3255607,3219811
SMI020-K04-B02-M03,0,1,Pf3D7_01_v3,95518,499681,404163
SMI020-K04-B02-M03,0,1,Pf3D7_01_v3,499969,567657,67688
SMI020-K04-B02-M03,0,1,Pf3D7_02_v3,109248,468251,359003
SMI020-K04-B02-M03,0,1,Pf3D7_02_v3,787412,862030,74618
SMI020-K04-B02-M03,0,1,Pf3D7_03_v3,71040,849683,778643
SMI020-K04-B02-M03,0,1,Pf3D7_03_v3,878750,1002946,124196
SMI020-K04-B02-M03,0,1,Pf3D7_04_v3,91817,1143965,1052148
SMI020-K04-B02-M03,0,1,Pf3D7_05_v3,39872,1321074,1281202
SMI020-K04-B02-M03,0,1,Pf3D7_06_v3,74373,113332,38959
SMI020-K04-B02-M03,0,1,Pf3D7_06_v3,114595,828863,714268
SMI020-K04-B02-M03,0,1,Pf3D7_06_v3,1269174,1294070,24896
SMI020-K04-B02-M03,0,1,Pf3D7_07_v3,77194,619957,542763
SMI020-K04-B02-M03,0,1,Pf3D7_07_v3,620660,1380526,759866
SMI020-K04-B02-M03,0,1,Pf3D7_08_v3,75691,1364499,1288808
SMI020-K04-B02-M03,0,1,Pf3D7_09_v3,82153,1472334,1390181
SMI020-K04-B02-M03,0,1,Pf3D7_10_v3,70764,185257,114493
SMI020-K04-B02-M03,0,1,Pf3D7_10_v3,270983,1326050,1055067
SMI020-K04-B02-M03,0,1,Pf3D7_10_v3,1344663,1570149,225486
SMI020-K04-B02-M03,0,1,Pf3D7_11_v3,110641,1382197,1271556
SMI020-K04-B02-M03,0,1,Pf3D7_11_v3,1743637,2003008,259371
SMI020-K04-B02-M03,0,1,Pf3D7_12_v3,61435,2155095,2093660
SMI020-K04-B02-M03,0,1,Pf3D7_13_v3,77901,2300842,2222941
SMI020-K04-B02-M03,0,1,Pf3D7_13_v3,2302511,2389824,87313
SMI020-K04-B02-M03,0,1,Pf3D7_13_v3,2410243,2788579,378336
SMI020-K04-B02-M03,0,1,Pf3D7_14_v3,35796,1336795,1300999
SMI020-K04-B02-M03,0,1,Pf3D7_14_v3,2035328,2473777,438449
SMI020-K04-B02-M03,0,1,Pf3D7_14_v3,3140785,3255607,114822
SMI022-K04-B03-M02,0,1,Pf3D7_01_v3,532656,534946,2290
SMI022-K04-B03-M02,0,1,Pf3D7_02_v3,311373,862030,550657
SMI022-K04-B03-M02,0,1,Pf3D7_03_v3,71040,565062,494022
SMI022-K04-B03-M02,0,1,Pf3D7_03_v3,804092,1002946,198854
SMI022-K04-B03-M02,0,1,Pf3D7_04_v3,91817,255939,164122
SMI022-K04-B03-M02,0,1,Pf3D7_04_v3,544534,1100949,556415
SMI022-K04-B03-M02,0,1,Pf3D7_05_v3,138524,269653,131129
SMI022-K04-B03-M02,0,1,Pf3D7_05_v3,897486,1204155,306669
SMI022-K04-B03-M02,0,1,Pf3D7_06_v3,116607,1294070,1177463
SMI022-K04-B03-M02,0,1,Pf3D7_07_v3,77194,221631,144437
SMI022-K04-B03-M02,0,1,Pf3D7_07_v3,344469,1380526,1036057
SMI022-K04-B03-M02,0,1,Pf3D7_08_v3,75691,426829,351138
SMI022-K04-B03-M02,0,1,Pf3D7_08_v3,467879,920130,452251
SMI022-K04-B03-M02,0,1,Pf3D7_08_v3,1113495,1178845,65350
SMI022-K04-B03-M02,0,1,Pf3D7_08_v3,1278610,1316718,38108
SMI022-K04-B03-M02,0,1,Pf3D7_09_v3,156473,202903,46430
SMI022-K04-B03-M02,0,1,Pf3D7_09_v3,416031,853207,437176
SMI022-K04-B03-M02,0,1,Pf3D7_10_v3,219055,1392421,1173366
SMI022-K04-B03-M02,0,1,Pf3D7_11_v3,778298,1008835,230537
SMI022-K04-B03-M02,0,1,Pf3D7_11_v3,1106452,1294584,188132
SMI022-K04-B03-M02,0,1,Pf3D7_11_v3,1404465,2003008,598543
SMI022-K04-B03-M02,0,1,Pf3D7_12_v3,61435,122749,61314
SMI022-K04-B03-M02,0,1,Pf3D7_12_v3,733520,845137,111617
SMI022-K04-B03-M02,0,1,Pf3D7_12_v3,1281594,1670700,389106
SMI022-K04-B03-M02,0,1,Pf3D7_13_v3,106161,2575636,2469475
SMI022-K04-B03-M02,0,1,Pf3D7_14_v3,393389,528659,135270
SMI022-K04-B03-M02,0,1,Pf3D7_14_v3,918720,2231863,1313143
SMI022-K04-B03-M02,0,1,Pf3D7_14_v3,2792758,3255607,462849
SMI026-K04-B03-M02,0,1,Pf3D7_01_v3,95518,567657,472139
SMI026-K04-B03-M02,0,1,Pf3D7_02_v3,109248,862030,752782
SMI026-K04-B03-M02,0,1,Pf3D7_03_v3,71040,891679,820639
SMI026-K04-B03-M02,0,1,Pf3D7_03_v3,925302,1002946,77644
SMI026-K04-B03-M02,0,1,Pf3D7_04_v3,91817,255939,164122
SMI026-K04-B03-M02,0,1,Pf3D7_04_v3,848303,999012,150709
SMI026-K04-B03-M02,0,1,Pf3D7_04_v3,1037822,1143965,106143
SMI026-K04-B03-M02,0,1,Pf3D7_05_v3,39872,41194,1322
SMI026-K04-B03-M02,0,1,Pf3D7_05_v3,279024,1185671,906647
SMI026-K04-B03-M02,0,1,Pf3D7_05_v3,1204155,1321074,116919
SMI026-K04-B03-M02,0,1,Pf3D7_06_v3,74373,542351,467978
SMI026-K04-B03-M02,0,1,Pf3D7_06_v3,796597,1294070,497473
SMI026-K04-B03-M02,0,1,Pf3D7_07_v3,77194,162477,85283
SMI026-K04-B03-M02,0,1,Pf3D7_07_v3,468540,1148859,680319
SMI026-K04-B03-M02,0,1,Pf3D7_07_v3,1202320,1380526,178206
SMI026-K04-B03-M02,0,1,Pf3D7_08_v3,75691,471880,396189
SMI026-K04-B03-M02,0,1,Pf3D7_08_v3,476916,856067,379151
SMI026-K04-B03-M02,0,1,Pf3D7_08_v3,1113495,1215502,102007
SMI026-K04-B03-M02,0,1,Pf3D7_09_v3,117818,202903,85085
SMI026-K04-B03-M02,0,1,Pf3D7_09_v3,516978,1062999,546021
SMI026-K04-B03-M02,0,1,Pf3D7_10_v3,1124529,1570149,445620
SMI026-K04-B03-M02,0,1,Pf3D7_11_v3,110641,123964,13323
SMI026-K04-B03-M02,0,1,Pf3D7_11_v3,204796,2003008,1798212
SMI026-K04-B03-M02,0,1,Pf3D7_12_v3,61435,382400,320965
SMI026-K04-B03-M02,0,1,Pf3D7_12_v3,907264,2155095,1247831
SMI026-K04-B03-M02,0,1,Pf3D7_13_v3,77901,106161,28260
SMI026-K04-B03-M02,0,1,Pf3D7_13_v3,1155190,2118702,963512
SMI026-K04-B03-M02,0,1,Pf3D7_13_v3,2575636,2788579,212943
SMI026-K04-B03-M02,0,1,Pf3D7_14_v3,35796,3121290,3085494
SMI027-K04-B01-M02,0,1,Pf3D7_01_v3,509256,567657,58401
SMI027-K04-B01-M02,0,1,Pf3D7_02_v3,109248,278236,168988
SMI027-K04-B01-M02,0,1,Pf3D7_02_v3,373975,805840,431865
SMI027-K04-B01-M02,0,1,Pf3D7_03_v3,140327,364059,223732
SMI027-K04-B01-M02,0,1,Pf3D7_04_v3,1130666,1143965,13299
SMI027-K04-B01-M02,0,1,Pf3D7_05_v3,39872,475188,435316
SMI027-K04-B01-M02,0,1,Pf3D7_05_v3,1038517,1175497,136980
SMI027-K04-B01-M02,0,1,Pf3D7_06_v3,272719,834384,561665
SMI027-K04-B01-M02,0,1,Pf3D7_07_v3,609312,1380526,771214
SMI027-K04-B01-M02,0,1,Pf3D7_08_v3,75691,476010,400319
SMI027-K04-B01-M02,0,1,Pf3D7_08_v3,1113495,1152268,38773
SMI027-K04-B01-M02,0,1,Pf3D7_08_v3,1176413,1317740,141327
SMI027-K04-B01-M02,0,1,Pf3D7_09_v3,413988,1014530,600542
SMI027-K04-B01-M02,0,1,Pf3D7_10_v3,1254230,1392014,137784
SMI027-K04-B01-M02,0,1,Pf3D7_10_v3,1398445,1570149,171704
SMI027-K04-B01-M02,0,1,Pf3D7_11_v3,110641,535357,424716
SMI027-K04-B01-M02,0,1,Pf3D7_14_v3,918720,1454960,536240
SMI027-K04-B01-M02,0,1,Pf3D7_14_v3,1484146,3126075,1641929
SMI027-K04-B01-M02,0,2,Pf3D7_01_v3,95518,178474,82956
SMI027-K04-B01-M02,0,2,Pf3D7_01_v3,509256,567657,58401
SMI027-K04-B01-M02,0,2,Pf3D7_02_v3,109248,373975,264727
SMI027-K04-B01-M02,0,2,Pf3D7_03_v3,364059,737321,373262
SMI027-K04-B01-M02,0,2,Pf3D7_03_v3,756863,1002946,246083
SMI027-K04-B01-M02,0,2,Pf3D7_04_v3,91817,738775,646958
SMI027-K04-B01-M02,0,2,Pf3D7_04_v3,830755,1130666,299911
SMI027-K04-B01-M02,0,2,Pf3D7_05_v3,329511,383150,53639
SMI027-K04-B01-M02,0,2,Pf3D7_05_v3,475188,1038517,563329
SMI027-K04-B01-M02,0,2,Pf3D7_05_v3,1175497,1321074,145577
SMI027-K04-B01-M02,0,2,Pf3D7_06_v3,74373,796597,722224
SMI027-K04-B01-M02,0,2,Pf3D7_06_v3,1111651,1253215,141564
SMI027-K04-B01-M02,0,2,Pf3D7_07_v3,78335,619957,541622
SMI027-K04-B01-M02,0,2,Pf3D7_08_v3,476010,916394,440384
SMI027-K04-B01-M02,0,2,Pf3D7_08_v3,1113495,1152268,38773
SMI027-K04-B01-M02,0,2,Pf3D7_08_v3,1167918,1176413,8495
SMI027-K04-B01-M02,0,2,Pf3D7_08_v3,1317740,1364499,46759
SMI027-K04-B01-M02,0,2,Pf3D7_09_v3,82153,170441,88288
SMI027-K04-B01-M02,0,2,Pf3D7_09_v3,231026,413988,182962
SMI027-K04-B01-M02,0,2,Pf3D7_09_v3,1140901,1472334,331433
SMI027-K04-B01-M02,0,2,Pf3D7_10_v3,70764,1031258,960494
SMI027-K04-B01-M02,0,2,Pf3D7_10_v3,1392014,1398445,6431
SMI027-K04-B01-M02,0,2,Pf3D7_11_v3,1294753,2003008,708255
SMI027-K04-B01-M02,0,2,Pf3D7_12_v3,61435,857245,795810
SMI027-K04-B01-M02,0,2,Pf3D7_12_v3,1670700,2155095,484395
SMI027-K04-B01-M02,0,2,Pf3D7_13_v3,77901,872241,794340
SMI027-K04-B01-M02,0,2,Pf3D7_13_v3,2735643,2788579,52936
SMI027-K04-B01-M02,0,2,Pf3D7_14_v3,35796,2451029,2415233
SMI027-K04-B01-M02,0,3,Pf3D7_01_v3,95518,178474,82956
SMI027-K04-B01-M02,0,3,Pf3D7_01_v3,509256,536113,26857
SMI027-K04-B01-M02,0,3,Pf3D7_02_v3,434163,784379,350216
SMI027-K04-B01-M02,0,3,Pf3D7_03_v3,737321,756863,19542
SMI027-K04-B01-M02,0,3,Pf3D7_04_v3,543724,794923,251199
SMI027-K04-B01-M02,0,3,Pf3D7_04_v3,830755,833197,2442
SMI027-K04-B01-M02,0,3,Pf3D7_04_v3,910443,923964,13521
SMI027-K04-B01-M02,0,3,Pf3D7_04_v3,1042880,1143965,101085
SMI027-K04-B01-M02,0,3,Pf3D7_05_v3,39872,216203,176331
SMI027-K04-B01-M02,0,3,Pf3D7_05_v3,329511,383150,53639
SMI027-K04-B01-M02,0,3,Pf3D7_05_v3,929884,1038517,108633
SMI027-K04-B01-M02,0,3,Pf3D7_06_v3,272719,315733,43014
SMI027-K04-B01-M02,0,3,Pf3D7_06_v3,796597,1252752,456155
SMI027-K04-B01-M02,0,3,Pf3D7_06_v3,1272170,1294070,21900
SMI027-K04-B01-M02,0,3,Pf3D7_07_v3,77194,78335,1141
SMI027-K04-B01-M02,0,3,Pf3D7_07_v3,609312,619957,10645
SMI027-K04-B01-M02,0,3,Pf3D7_07_v3,627405,1380526,753121
SMI027-K04-B01-M02,0,3,Pf3D7_08_v3,75691,308234,232543
SMI027-K04-B01-M02,0,3,Pf3D7_08_v3,328025,476010,147985
SMI027-K04-B01-M02,0,3,Pf3D7_08_v3,916394,1167918,251524
SMI027-K04-B01-M02,0,3,Pf3D7_08_v3,1176413,1317740,141327
SMI027-K04-B01-M02,0,3,Pf3D7_09_v3,416031,850094,434063
SMI027-K04-B01-M02,0,3,Pf3D7_09_v3,1014530,1140901,126371
SMI027-K04-B01-M02,0,3,Pf3D7_10_v3,562016,742524,180508
SMI027-K04-B01-M02,0,3,Pf3D7_10_v3,1031258,1254230,222972
SMI027-K04-B01-M02,0,3,Pf3D7_10_v3,1393752,1398445,4693
SMI027-K04-B01-M02,0,3,Pf3D7_10_v3,1432013,1570149,138136
SMI027-K04-B01-M02,0,3,Pf3D7_11_v3,110641,1294584,1183943
SMI027-K04-B01-M02,0,3,Pf3D7_12_v3,857245,1229032,371787
SMI027-K04-B01-M02,0,3,Pf3D7_12_v3,1670700,2155095,484395
SMI027-K04-B01-M02,0,3,Pf3D7_13_v3,77901,106161,28260
SMI027-K04-B01-M02,0,3,Pf3D7_13_v3,868418,872241,3823
SMI027-K04-B01-M02,0,3,Pf3D7_14_v3,406995,1454960,1047965
SMI027-K04-B01-M02,0,3,Pf3D7_14_v3,1484146,3126075,1641929
SMI027-K04-B01-M02,1,2,Pf3D7_01_v3,178474,567657,389183
SMI027-K04-B01-M02,1,2,Pf3D7_02_v3,109248,278236,168988
SMI027-K04-B01-M02,1,2,Pf3D7_02_v3,805840,862030,56190
SMI027-K04-B01-M02,1,2,Pf3D7_03_v3,71040,140327,69287
SMI027-K04-B01-M02,1,2,Pf3D7_03_v3,737321,756863,19542
SMI027-K04-B01-M02,1,2,Pf3D7_04_v3,738775,830755,91980
SMI027-K04-B01-M02,1,2,Pf3D7_05_v3,329511,383150,53639
SMI027-K04-B01-M02,1,2,Pf3D7_06_v3,272719,796597,523878
SMI027-K04-B01-M02,1,2,Pf3D7_06_v3,834384,1111651,277267
SMI027-K04-B01-M02,1,2,Pf3D7_06_v3,1253215,1294070,40855
SMI027-K04-B01-M02,1,2,Pf3D7_07_v3,77194,78335,1141
SMI027-K04-B01-M02,1,2,Pf3D7_07_v3,609312,619957,10645
SMI027-K04-B01-M02,1,2,Pf3D7_08_v3,916394,1167918,251524
SMI027-K04-B01-M02,1,2,Pf3D7_09_v3,170441,231026,60585
SMI027-K04-B01-M02,1,2,Pf3D7_09_v3,1014530,1140901,126371
SMI027-K04-B01-M02,1,2,Pf3D7_10_v3,1031258,1254230,222972
SMI027-K04-B01-M02,1,2,Pf3D7_11_v3,535357,1294753,759396
SMI027-K04-B01-M02,1,2,Pf3D7_12_v3,857245,1670700,813455
SMI027-K04-B01-M02,1,2,Pf3D7_13_v3,872241,2735643,1863402
SMI027-K04-B01-M02,1,2,Pf3D7_14_v3,918720,1454960,536240
SMI027-K04-B01-M02,1,2,Pf3D7_14_v3,1484146,2451029,966883
SMI027-K04-B01-M02,1,2,Pf3D7_14_v3,3126075,3255607,129532
SMI027-K04-B01-M02,1,3,Pf3D7_01_v3,178474,536113,357639
SMI027-K04-B01-M02,1,3,Pf3D7_02_v3,434163,784379,350216
SMI027-K04-B01-M02,1,3,Pf3D7_02_v3,805840,862030,56190
SMI027-K04-B01-M02,1,3,Pf3D7_03_v3,71040,140327,69287
SMI027-K04-B01-M02,1,3,Pf3D7_03_v3,390553,737321,346768
SMI027-K04-B01-M02,1,3,Pf3D7_03_v3,756863,878750,121887
SMI027-K04-B01-M02,1,3,Pf3D7_04_v3,255939,428163,172224
SMI027-K04-B01-M02,1,3,Pf3D7_04_v3,485881,543724,57843
SMI027-K04-B01-M02,1,3,Pf3D7_04_v3,794923,830755,35832
SMI027-K04-B01-M02,1,3,Pf3D7_04_v3,833197,910443,77246
SMI027-K04-B01-M02,1,3,Pf3D7_04_v3,923964,999012,75048
SMI027-K04-B01-M02,1,3,Pf3D7_04_v3,1002051,1042880,40829
SMI027-K04-B01-M02,1,3,Pf3D7_04_v3,1130666,1143965,13299
SMI027-K04-B01-M02,1,3,Pf3D7_05_v3,39872,216203,176331
SMI027-K04-B01-M02,1,3,Pf3D7_05_v3,329511,383150,53639
SMI027-K04-B01-M02,1,3,Pf3D7_05_v3,753909,929884,175975
SMI027-K04-B01-M02,1,3,Pf3D7_05_v3,1175497,1321074,145577
SMI027-K04-B01-M02,1,3,Pf3D7_06_v3,74373,315733,241360
SMI027-K04-B01-M02,1,3,Pf3D7_06_v3,796597,834384,37787
SMI027-K04-B01-M02,1,3,Pf3D7_07_v3,78335,619957,541622
SMI027-K04-B01-M02,1,3,Pf3D7_07_v3,627405,1380526,753121
SMI027-K04-B01-M02,1,3,Pf3D7_08_v3,75691,308234,232543
SMI027-K04-B01-M02,1,3,Pf3D7_08_v3,328025,916394,588369
SMI027-K04-B01-M02,1,3,Pf3D7_08_v3,1113495,1152268,38773
SMI027-K04-B01-M02,1,3,Pf3D7_08_v3,1167918,1364499,196581
SMI027-K04-B01-M02,1,3,Pf3D7_09_v3,82153,231026,148873
SMI027-K04-B01-M02,1,3,Pf3D7_09_v3,416031,850094,434063
SMI027-K04-B01-M02,1,3,Pf3D7_09_v3,1140901,1472334,331433
SMI027-K04-B01-M02,1,3,Pf3D7_10_v3,70764,562016,491252
SMI027-K04-B01-M02,1,3,Pf3D7_10_v3,742524,1031258,288734
SMI027-K04-B01-M02,1,3,Pf3D7_10_v3,1432013,1570149,138136
SMI027-K04-B01-M02,1,3,Pf3D7_11_v3,110641,535357,424716
SMI027-K04-B01-M02,1,3,Pf3D7_11_v3,1294584,1995902,701318
SMI027-K04-B01-M02,1,3,Pf3D7_12_v3,382400,857245,474845
SMI027-K04-B01-M02,1,3,Pf3D7_13_v3,106161,374833,268672
SMI027-K04-B01-M02,1,3,Pf3D7_13_v3,872241,2575636,1703395
SMI027-K04-B01-M02,1,3,Pf3D7_14_v3,918720,3255607,2336887
SMI027-K04-B01-M02,2,3,Pf3D7_01_v3,95518,536113,440595
SMI027-K04-B01-M02,2,3,Pf3D7_02_v3,784379,862030,77651
SMI027-K04-B01-M02,2,3,Pf3D7_03_v3,71040,357947,286907
SMI027-K04-B01-M02,2,3,Pf3D7_04_v3,543724,738775,195051
SMI027-K04-B01-M02,2,3,Pf3D7_04_v3,794923,833197,38274
SMI027-K04-B01-M02,2,3,Pf3D7_04_v3,910443,923964,13521
SMI027-K04-B01-M02,2,3,Pf3D7_04_v3,1042880,1130666,87786
SMI027-K04-B01-M02,2,3,Pf3D7_05_v3,216203,383150,166947
SMI027-K04-B01-M02,2,3,Pf3D7_05_v3,929884,1175497,245613
SMI027-K04-B01-M02,2,3,Pf3D7_06_v3,272719,315733,43014
SMI027-K04-B01-M02,2,3,Pf3D7_06_v3,1111651,1252752,141101
SMI027-K04-B01-M02,2,3,Pf3D7_07_v3,609312,627405,18093
SMI027-K04-B01-M02,2,3,Pf3D7_08_v3,308234,328025,19791
SMI027-K04-B01-M02,2,3,Pf3D7_08_v3,1113495,1152268,38773
SMI027-K04-B01-M02,2,3,Pf3D7_09_v3,170441,231026,60585
SMI027-K04-B01-M02,2,3,Pf3D7_09_v3,850094,1014530,164436
SMI027-K04-B01-M02,2,3,Pf3D7_10_v3,562016,742524,180508
SMI027-K04-B01-M02,2,3,Pf3D7_10_v3,1393752,1432013,38261
SMI027-K04-B01-M02,2,3,Pf3D7_11_v3,1294584,1294753,169
SMI027-K04-B01-M02,2,3,Pf3D7_12_v3,1670700,2155095,484395
SMI027-K04-B01-M02,2,3,Pf3D7_13_v3,77901,106161,28260
SMI027-K04-B01-M02,2,3,Pf3D7_13_v3,868418,2575636,1707218
SMI027-K04-B01-M02,2,3,Pf3D7_14_v3,406995,1454960,1047965
SMI027-K04-B01-M02,2,3,Pf3D7_14_v3,1484146,2451029,966883
SMI027-K04-B01-M02,2,3,Pf3D7_14_v3,3126075,3255607,129532
SMI028-K04-B02-M03,0,1,Pf3D7_01_v3,95518,567657,472139
SMI028-K04-B02-M03,0,1,Pf3D7_02_v3,109248,297229,187981
SMI028-K04-B02-M03,0,1,Pf3D7_02_v3,311475,805840,494365
SMI028-K04-B02-M03,0,1,Pf3D7_03_v3,77481,1002946,925465
SMI028-K04-B02-M03,0,1,Pf3D7_04_v3,91817,133982,42165
SMI028-K04-B02-M03,0,1,Pf3D7_04_v3,147600,255939,108339
SMI028-K04-B02-M03,0,1,Pf3D7_04_v3,398819,630569,231750
SMI028-K04-B02-M03,0,1,Pf3D7_04_v3,792225,889062,96837
SMI028-K04-B02-M03,0,1,Pf3D7_04_v3,991236,1143965,152729
SMI028-K04-B02-M03,0,1,Pf3D7_05_v3,39872,1178624,1138752
SMI028-K04-B02-M03,0,1,Pf3D7_05_v3,1245422,1283360,37938
SMI028-K04-B02-M03,0,1,Pf3D7_05_v3,1289061,1321074,32013
SMI028-K04-B02-M03,0,1,Pf3D7_06_v3,74373,799889,725516
SMI028-K04-B02-M03,0,1,Pf3D7_06_v3,1111651,1294070,182419
SMI028-K04-B02-M03,0,1,Pf3D7_07_v3,77194,455362,378168
SMI028-K04-B02-M03,0,1,Pf3D7_07_v3,480458,619957,139499
SMI028-K04-B02-M03,0,1,Pf3D7_07_v3,635759,1380526,744767
SMI028-K04-B02-M03,0,1,Pf3D7_08_v3,75691,191200,115509
SMI028-K04-B02-M03,0,1,Pf3D7_08_v3,308234,501042,192808
SMI028-K04-B02-M03,0,1,Pf3D7_08_v3,509018,1311822,802804
SMI028-K04-B02-M03,0,1,Pf3D7_09_v3,265317,686246,420929
SMI028-K04-B02-M03,0,1,Pf3D7_09_v3,880434,1206357,325923
SMI028-K04-B02-M03,0,1,Pf3D7_10_v3,75884,1254230,1178346
SMI028-K04-B02-M03,0,1,Pf3D7_10_v3,1327364,1394281,66917
SMI028-K04-B02-M03,0,1,Pf3D7_10_v3,1432783,1570149,137366
SMI028-K04-B02-M03,0,1,Pf3D7_11_v3,110641,1749819,1639178
SMI028-K04-B02-M03,0,1,Pf3D7_11_v3,1813458,1978659,165201
SMI028-K04-B02-M03,0,1,Pf3D7_12_v3,382400,2155095,1772695
SMI028-K04-B02-M03,0,1,Pf3D7_13_v3,77901,1007526,929625
SMI028-K04-B02-M03,0,1,Pf3D7_13_v3,2575636,2788579,212943
SMI028-K04-B02-M03,0,1,Pf3D7_14_v3,35796,2006084,1970288
SMI028-K04-B02-M03,0,1,Pf3D7_14_v3,3193462,3255607,62145
SMI028-K04-B02-M03,0,2,Pf3D7_01_v3,95518,567657,472139
SMI028-K04-B02-M03,0,2,Pf3D7_02_v3,109248,468251,359003
SMI028-K04-B02-M03,0,2,Pf3D7_03_v3,77481,1002946,925465
SMI028-K04-B02-M03,0,2,Pf3D7_04_v3,91817,133982,42165
SMI028-K04-B02-M03,0,2,Pf3D7_04_v3,142913,528936,386023
SMI028-K04-B02-M03,0,2,Pf3D7_04_v3,630569,991236,360667
SMI028-K04-B02-M03,0,2,Pf3D7_04_v3,999012,1094136,95124
SMI028-K04-B02-M03,0,2,Pf3D7_05_v3,154819,1114074,959255
SMI028-K04-B02-M03,0,2,Pf3D7_05_v3,1178624,1213673,35049
SMI028-K04-B02-M03,0,2,Pf3D7_05_v3,1283360,1289061,5701
SMI028-K04-B02-M03,0,2,Pf3D7_06_v3,116243,796597,680354
SMI028-K04-B02-M03,0,2,Pf3D7_06_v3,799889,1294070,494181
SMI028-K04-B02-M03,0,2,Pf3D7_07_v3,77194,455362,378168
SMI028-K04-B02-M03,0,2,Pf3D7_07_v3,480458,619957,139499
SMI028-K04-B02-M03,0,2,Pf3D7_07_v3,635759,1380526,744767
SMI028-K04-B02-M03,0,2,Pf3D7_08_v3,75691,191200,115509
SMI028-K04-B02-M03,0,2,Pf3D7_08_v3,331539,424720,93181
SMI028-K04-B02-M03,0,2,Pf3D7_08_v3,501042,1310903,809861
SMI028-K04-B02-M03,0,2,Pf3D7_08_v3,1311822,1364499,52677
SMI028-K04-B02-M03,0,2,Pf3D7_09_v3,82153,265317,183164
SMI028-K04-B02-M03,0,2,Pf3D7_09_v3,416031,586735,170704
SMI028-K04-B02-M03,0,2,Pf3D7_09_v3,686246,880434,194188
SMI028-K04-B02-M03,0,2,Pf3D7_09_v3,1206357,1472334,265977
SMI028-K04-B02-M03,0,2,Pf3D7_10_v3,70764,1295838,1225074
SMI028-K04-B02-M03,0,2,Pf3D7_10_v3,1432783,1570149,137366
SMI028-K04-B02-M03,0,2,Pf3D7_11_v3,110641,1749819,1639178
SMI028-K04-B02-M03,0,2,Pf3D7_11_v3,1856952,2003008,146056
SMI028-K04-B02-M03,0,2,Pf3D7_12_v3,61435,2155095,2093660
SMI028-K04-B02-M03,0,2,Pf3D7_13_v3,77901,1007526,929625
SMI028-K04-B02-M03,0,2,Pf3D7_13_v3,1682933,2575636,892703
SMI028-K04-B02-M03,0,2,Pf3D7_13_v3,2595574,2788579,193005
SMI028-K04-B02-M03,0,2,Pf3D7_14_v3,35796,2006084,1970288
SMI028-K04-B02-M03,0,2,Pf3D7_14_v3,3131485,3193462,61977
SMI028-K04-B02-M03,1,2,Pf3D7_01_v3,95518,567657,472139
SMI028-K04-B02-M03,1,2,Pf3D7_02_v3,109248,297229,187981
SMI028-K04-B02-M03,1,2,Pf3D7_02_v3,311475,468251,156776
SMI028-K04-B02-M03,1,2,Pf3D7_02_v3,805840,862030,56190
SMI028-K04-B02-M03,1,2,Pf3D7_03_v3,71040,1002946,931906
SMI028-K04-B02-M03,1,2,Pf3D7_04_v3,91817,142913,51096
SMI028-K04-B02-M03,1,2,Pf3D7_04_v3,147600,255939,108339
SMI028-K04-B02-M03,1,2,Pf3D7_04_v3,398819,528936,130117
SMI028-K04-B02-M03,1,2,Pf3D7_04_v3,792225,889062,96837
SMI028-K04-B02-M03,1,2,Pf3D7_04_v3,999012,1094136,95124
SMI028-K04-B02-M03,1,2,Pf3D7_05_v3,154819,1114074,959255
SMI028-K04-B02-M03,1,2,Pf3D7_05_v3,1213673,1245422,31749
SMI028-K04-B02-M03,1,2,Pf3D7_06_v3,116243,796597,680354
SMI028-K04-B02-M03,1,2,Pf3D7_06_v3,1111651,1294070,182419
SMI028-K04-B02-M03,1,2,Pf3D7_07_v3,77194,1380526,1303332
SMI028-K04-B02-M03,1,2,Pf3D7_08_v3,75691,308234,232543
SMI028-K04-B02-M03,1,2,Pf3D7_08_v3,331539,424720,93181
SMI028-K04-B02-M03,1,2,Pf3D7_08_v3,509018,1310903,801885
SMI028-K04-B02-M03,1,2,Pf3D7_09_v3,416031,586735,170704
SMI028-K04-B02-M03,1,2,Pf3D7_10_v3,75884,1254230,1178346
SMI028-K04-B02-M03,1,2,Pf3D7_10_v3,1295838,1327364,31526
SMI028-K04-B02-M03,1,2,Pf3D7_10_v3,1394281,1570149,175868
SMI028-K04-B02-M03,1,2,Pf3D7_11_v3,110641,1813458,1702817
SMI028-K04-B02-M03,1,2,Pf3D7_11_v3,1856952,1978659,121707
SMI028-K04-B02-M03,1,2,Pf3D7_12_v3,382400,2155095,1772695
SMI028-K04-B02-M03,1,2,Pf3D7_13_v3,77901,1682933,1605032
SMI028-K04-B02-M03,1,2,Pf3D7_13_v3,2595574,2788579,193005
SMI028-K04-B02-M03,1,2,Pf3D7_14_v3,35796,3131485,3095689
SMI029-K04-B01-M02,0,1,Pf3D7_01_v3,487895,567657,79762
SMI029-K04-B01-M02,0,1,Pf3D7_02_v3,109248,862030,752782
SMI029-K04-B01-M02,0,1,Pf3D7_03_v3,71040,444950,373910
SMI029-K04-B01-M02,0,1,Pf3D7_04_v3,255939,999012,743073
SMI029-K04-B01-M02,0,1,Pf3D7_04_v3,1037822,1143965,106143
SMI029-K04-B01-M02,0,1,Pf3D7_05_v3,39872,383150,343278
SMI029-K04-B01-M02,0,1,Pf3D7_05_v3,908826,1038517,129691
SMI029-K04-B01-M02,0,1,Pf3D7_06_v3,628195,847157,218962
SMI029-K04-B01-M02,0,1,Pf3D7_06_v3,1111651,1290486,178835
SMI029-K04-B01-M02,0,1,Pf3D7_07_v3,619957,1019630,399673
SMI029-K04-B01-M02,0,1,Pf3D7_08_v3,473918,1278610,804692
SMI029-K04-B01-M02,0,1,Pf3D7_08_v3,1363159,1364499,1340
SMI029-K04-B01-M02,0,1,Pf3D7_09_v3,82153,165871,83718
SMI029-K04-B01-M02,0,1,Pf3D7_10_v3,257324,1570149,1312825
SMI029-K04-B01-M02,0,1,Pf3D7_11_v3,110641,468283,357642
SMI029-K04-B01-M02,0,1,Pf3D7_11_v3,778298,1015466,237168
SMI029-K04-B01-M02,0,1,Pf3D7_11_v3,1294584,2003008,708424
SMI029-K04-B01-M02,0,1,Pf3D7_12_v3,61435,63177,1742
SMI029-K04-B01-M02,0,1,Pf3D7_12_v3,122749,382400,259651
SMI029-K04-B01-M02,0,1,Pf3D7_12_v3,483437,2155095,1671658
SMI029-K04-B01-M02,0,1,Pf3D7_13_v3,77901,1466348,1388447
SMI029-K04-B01-M02,0,1,Pf3D7_13_v3,1565364,1891015,325651
SMI029-K04-B01-M02,0,1,Pf3D7_13_v3,2575636,2788579,212943
SMI029-K04-B01-M02,0,1,Pf3D7_14_v3,35796,918720,882924
SMI029-K04-B01-M02,0,2,Pf3D7_01_v3,95518,487895,392377
SMI029-K04-B01-M02,0,2,Pf3D7_02_v3,468251,862030,393779
SMI029-K04-B01-M02,0,2,Pf3D7_03_v3,71040,390553,319513
SMI029-K04-B01-M02,0,2,Pf3D7_04_v3,255939,766795,510856
SMI029-K04-B01-M02,0,2,Pf3D7_04_v3,812570,1037822,225252
SMI029-K04-B01-M02,0,2,Pf3D7_04_v3,1101687,1143965,42278
SMI029-K04-B01-M02,0,2,Pf3D7_05_v3,39872,908826,868954
SMI029-K04-B01-M02,0,2,Pf3D7_06_v3,229484,628195,398711
SMI029-K04-B01-M02,0,2,Pf3D7_07_v3,495462,619957,124495
SMI029-K04-B01-M02,0,2,Pf3D7_08_v3,1278610,1364499,85889
SMI029-K04-B01-M02,0,2,Pf3D7_09_v3,82153,225542,143389
SMI029-K04-B01-M02,0,2,Pf3D7_09_v3,500646,1472334,971688
SMI029-K04-B01-M02,0,2,Pf3D7_10_v3,70764,257324,186560
SMI029-K04-B01-M02,0,2,Pf3D7_11_v3,468283,1557734,1089451
SMI029-K04-B01-M02,0,2,Pf3D7_12_v3,122749,1670700,1547951
SMI029-K04-B01-M02,0,2,Pf3D7_13_v3,106161,1466348,1360187
SMI029-K04-B01-M02,0,2,Pf3D7_13_v3,1565364,1891015,325651
SMI029-K04-B01-M02,0,2,Pf3D7_13_v3,2575636,2788579,212943
SMI029-K04-B01-M02,0,2,Pf3D7_14_v3,35796,413421,377625
SMI029-K04-B01-M02,0,2,Pf3D7_14_v3,855174,872715,17541
SMI029-K04-B01-M02,0,2,Pf3D7_14_v3,2744225,3255607,511382
SMI029-K04-B01-M02,0,3,Pf3D7_01_v3,487895,535884,47989
SMI029-K04-B01-M02,0,3,Pf3D7_02_v3,468251,862030,393779
SMI029-K04-B01-M02,0,3,Pf3D7_03_v3,71040,878750,807710
SMI029-K04-B01-M02,0,3,Pf3D7_04_v3,255939,920566,664627
SMI029-K04-B01-M02,0,3,Pf3D7_04_v3,991455,1063155,71700
SMI029-K04-B01-M02,0,3,Pf3D7_04_v3,1100949,1143965,43016
SMI029-K04-B01-M02,0,3,Pf3D7_05_v3,39872,383150,343278
SMI029-K04-B01-M02,0,3,Pf3D7_05_v3,563411,1321074,757663
SMI029-K04-B01-M02,0,3,Pf3D7_06_v3,74373,200713,126340
SMI029-K04-B01-M02,0,3,Pf3D7_06_v3,1111651,1294070,182419
SMI029-K04-B01-M02,0,3,Pf3D7_07_v3,77194,495462,418268
SMI029-K04-B01-M02,0,3,Pf3D7_08_v3,490297,707340,217043
SMI029-K04-B01-M02,0,3,Pf3D7_08_v3,1363159,1364499,1340
SMI029-K04-B01-M02,0,3,Pf3D7_09_v3,82153,165871,83718
SMI029-K04-B01-M02,0,3,Pf3D7_09_v3,225542,370705,145163
SMI029-K04-B01-M02,0,3,Pf3D7_09_v3,1199384,1335843,136459
SMI029-K04-B01-M02,0,3,Pf3D7_10_v3,454626,695825,241199
SMI029-K04-B01-M02,0,3,Pf3D7_10_v3,1254230,1570149,315919
SMI029-K04-B01-M02,0,3,Pf3D7_11_v3,110641,468283,357642
SMI029-K04-B01-M02,0,3,Pf3D7_11_v3,778298,1015466,237168
SMI029-K04-B01-M02,0,3,Pf3D7_11_v3,1294584,1557734,263150
SMI029-K04-B01-M02,0,3,Pf3D7_12_v3,122749,382400,259651
SMI029-K04-B01-M02,0,3,Pf3D7_12_v3,1560552,1670700,110148
SMI029-K04-B01-M02,0,3,Pf3D7_13_v3,106161,274115,167954
SMI029-K04-B01-M02,0,3,Pf3D7_13_v3,585306,1406105,820799
SMI029-K04-B01-M02,0,3,Pf3D7_13_v3,2575636,2634804,59168
SMI029-K04-B01-M02,0,3,Pf3D7_14_v3,1038446,2451029,1412583
SMI029-K04-B01-M02,1,2,Pf3D7_02_v3,468251,862030,393779
SMI029-K04-B01-M02,1,2,Pf3D7_03_v3,71040,390553,319513
SMI029-K04-B01-M02,1,2,Pf3D7_03_v3,444950,1002946,557996
SMI029-K04-B01-M02,1,2,Pf3D7_04_v3,91817,766795,674978
SMI029-K04-B01-M02,1,2,Pf3D7_04_v3,812570,999012,186442
SMI029-K04-B01-M02,1,2,Pf3D7_04_v3,1101687,1143965,42278
SMI029-K04-B01-M02,1,2,Pf3D7_05_v3,39872,383150,343278
SMI029-K04-B01-M02,1,2,Pf3D7_05_v3,1038517,1321074,282557
SMI029-K04-B01-M02,1,2,Pf3D7_06_v3,74373,229484,155111
SMI029-K04-B01-M02,1,2,Pf3D7_06_v3,847157,1111651,264494
SMI029-K04-B01-M02,1,2,Pf3D7_06_v3,1290486,1294070,3584
SMI029-K04-B01-M02,1,2,Pf3D7_07_v3,77194,495462,418268
SMI029-K04-B01-M02,1,2,Pf3D7_07_v3,1019630,1380526,360896
SMI029-K04-B01-M02,1,2,Pf3D7_08_v3,75691,473918,398227
SMI029-K04-B01-M02,1,2,Pf3D7_08_v3,1363159,1364499,1340
SMI029-K04-B01-M02,1,2,Pf3D7_09_v3,82153,165871,83718
SMI029-K04-B01-M02,1,2,Pf3D7_09_v3,225542,500646,275104
SMI029-K04-B01-M02,1,2,Pf3D7_11_v3,778298,1015466,237168
SMI029-K04-B01-M02,1,2,Pf3D7_11_v3,1294584,1557734,263150
SMI029-K04-B01-M02,1,2,Pf3D7_12_v3,63177,382400,319223
SMI029-K04-B01-M02,1,2,Pf3D7_12_v3,483437,1670700,1187263
SMI029-K04-B01-M02,1,2,Pf3D7_13_v3,106161,2788579,2682418
SMI029-K04-B01-M02,1,2,Pf3D7_14_v3,35796,413421,377625
SMI029-K04-B01-M02,1,2,Pf3D7_14_v3,855174,872715,17541
SMI029-K04-B01-M02,1,2,Pf3D7_14_v3,918720,2744225,1825505
SMI029-K04-B01-M02,1,3,Pf3D7_01_v3,180170,535884,355714
SMI029-K04-B01-M02,1,3,Pf3D7_02_v3,468251,862030,393779
SMI029-K04-B01-M02,1,3,Pf3D7_03_v3,71040,444950,373910
SMI029-K04-B01-M02,1,3,Pf3D7_04_v3,147659,920566,772907
SMI029-K04-B01-M02,1,3,Pf3D7_04_v3,991455,999012,7557
SMI029-K04-B01-M02,1,3,Pf3D7_04_v3,1037822,1063155,25333
SMI029-K04-B01-M02,1,3,Pf3D7_04_v3,1100949,1143965,43016
SMI029-K04-B01-M02,1,3,Pf3D7_05_v3,39872,383150,343278
SMI029-K04-B01-M02,1,3,Pf3D7_05_v3,908826,1038517,129691
SMI029-K04-B01-M02,1,3,Pf3D7_06_v3,1111651,1290486,178835
SMI029-K04-B01-M02,1,3,Pf3D7_07_v3,495462,619957,124495
SMI029-K04-B01-M02,1,3,Pf3D7_08_v3,490297,707340,217043
SMI029-K04-B01-M02,1,3,Pf3D7_08_v3,1315035,1364499,49464
SMI029-K04-B01-M02,1,3,Pf3D7_09_v3,82153,225542,143389
SMI029-K04-B01-M02,1,3,Pf3D7_10_v3,454626,695825,241199
SMI029-K04-B01-M02,1,3,Pf3D7_10_v3,1254230,1570149,315919
SMI029-K04-B01-M02,1,3,Pf3D7_11_v3,110641,1557734,1447093
SMI029-K04-B01-M02,1,3,Pf3D7_12_v3,63177,382400,319223
SMI029-K04-B01-M02,1,3,Pf3D7_12_v3,1560552,1670700,110148
SMI029-K04-B01-M02,1,3,Pf3D7_13_v3,106161,274115,167954
SMI029-K04-B01-M02,1,3,Pf3D7_13_v3,585306,1406105,820799
SMI029-K04-B01-M02,1,3,Pf3D7_13_v3,2575636,2634804,59168
SMI029-K04-B01-M02,2,3,Pf3D7_01_v3,535884,567657,31773
SMI029-K04-B01-M02,2,3,Pf3D7_02_v3,109248,253753,144505
SMI029-K04-B01-M02,2,3,Pf3D7_02_v3,416191,862030,445839
SMI029-K04-B01-M02,2,3,Pf3D7_03_v3,71040,390553,319513
SMI029-K04-B01-M02,2,3,Pf3D7_04_v3,147659,766795,619136
SMI029-K04-B01-M02,2,3,Pf3D7_04_v3,812570,920566,107996
SMI029-K04-B01-M02,2,3,Pf3D7_04_v3,991455,1037822,46367
SMI029-K04-B01-M02,2,3,Pf3D7_04_v3,1101687,1143965,42278
SMI029-K04-B01-M02,2,3,Pf3D7_05_v3,39872,383150,343278
SMI029-K04-B01-M02,2,3,Pf3D7_05_v3,563411,908826,345415
SMI029-K04-B01-M02,2,3,Pf3D7_08_v3,1363159,1364499,1340
SMI029-K04-B01-M02,2,3,Pf3D7_09_v3,82153,165871,83718
SMI029-K04-B01-M02,2,3,Pf3D7_09_v3,1199384,1335843,136459
SMI029-K04-B01-M02,2,3,Pf3D7_10_v3,695825,1254230,558405
SMI029-K04-B01-M02,2,3,Pf3D7_11_v3,778298,1015466,237168
SMI029-K04-B01-M02,2,3,Pf3D7_11_v3,1294584,2003008,708424
SMI029-K04-B01-M02,2,3,Pf3D7_12_v3,61435,382400,320965
SMI029-K04-B01-M02,2,3,Pf3D7_12_v3,1560552,1670700,110148
SMI029-K04-B01-M02,2,3,Pf3D7_13_v3,106161,274115,167954
SMI029-K04-B01-M02,2,3,Pf3D7_13_v3,585306,1406105,820799
SMI029-K04-B01-M02,2,3,Pf3D7_13_v3,2575636,2634804,59168
SMI030-K04-B01-M03,0,1,Pf3D7_02_v3,414955,805840,390885
SMI030-K04-B01-M03,0,1,Pf3D7_03_v3,878750,1002946,124196
SMI030-K04-B01-M03,0,1,Pf3D7_04_v3,91817,989851,898034
SMI030-K04-B01-M03,0,1,Pf3D7_04_v3,991236,1143965,152729
SMI030-K04-B01-M03,0,1,Pf3D7_05_v3,39872,132885,93013
SMI030-K04-B01-M03,0,1,Pf3D7_05_v3,288857,1321074,1032217
SMI030-K04-B01-M03,0,1,Pf3D7_06_v3,74373,1294070,1219697
SMI030-K04-B01-M03,0,1,Pf3D7_07_v3,77194,466102,388908
SMI030-K04-B01-M03,0,1,Pf3D7_07_v3,619957,1380526,760569
SMI030-K04-B01-M03,0,1,Pf3D7_08_v3,75691,164893,89202
SMI030-K04-B01-M03,0,1,Pf3D7_08_v3,1113495,1364499,251004
SMI030-K04-B01-M03,0,1,Pf3D7_09_v3,82153,1472334,1390181
SMI030-K04-B01-M03,0,1,Pf3D7_10_v3,70764,1570149,1499385
SMI030-K04-B01-M03,0,1,Pf3D7_11_v3,110641,287983,177342
SMI030-K04-B01-M03,0,1,Pf3D7_11_v3,354035,528101,174066
SMI030-K04-B01-M03,0,1,Pf3D7_11_v3,1294584,2003008,708424
SMI030-K04-B01-M03,0,1,Pf3D7_12_v3,61435,1212111,1150676
SMI030-K04-B01-M03,0,1,Pf3D7_12_v3,1397156,2155095,757939
SMI030-K04-B01-M03,0,1,Pf3D7_13_v3,77901,106161,28260
SMI030-K04-B01-M03,0,1,Pf3D7_13_v3,367468,934650,567182
SMI030-K04-B01-M03,0,1,Pf3D7_13_v3,956051,2788579,1832528
SMI030-K04-B01-M03,0,1,Pf3D7_14_v3,35796,918720,882924
SMI030-K04-B01-M03,0,1,Pf3D7_14_v3,1393032,3255607,1862575
SMI030-K04-B01-M03,0,2,Pf3D7_01_v3,527341,567657,40316
SMI030-K04-B01-M03,0,2,Pf3D7_02_v3,109248,414955,305707
SMI030-K04-B01-M03,0,2,Pf3D7_02_v3,468251,805840,337589
SMI030-K04-B01-M03,0,2,Pf3D7_03_v3,221547,758506,536959
SMI030-K04-B01-M03,0,2,Pf3D7_03_v3,878750,1002946,124196
SMI030-K04-B01-M03,0,2,Pf3D7_04_v3,91817,991236,899419
SMI030-K04-B01-M03,0,2,Pf3D7_04_v3,999012,1143965,144953
SMI030-K04-B01-M03,0,2,Pf3D7_05_v3,39872,1321074,1281202
SMI030-K04-B01-M03,0,2,Pf3D7_06_v3,74373,1111651,1037278
SMI030-K04-B01-M03,0,2,Pf3D7_07_v3,298978,460942,161964
SMI030-K04-B01-M03,0,2,Pf3D7_07_v3,495789,1380526,884737
SMI030-K04-B01-M03,0,2,Pf3D7_08_v3,75691,164893,89202
SMI030-K04-B01-M03,0,2,Pf3D7_08_v3,362183,426411,64228
SMI030-K04-B01-M03,0,2,Pf3D7_08_v3,677481,1109232,431751
SMI030-K04-B01-M03,0,2,Pf3D7_08_v3,1113495,1364499,251004
SMI030-K04-B01-M03,0,2,Pf3D7_09_v3,82153,1436710,1354557
SMI030-K04-B01-M03,0,2,Pf3D7_10_v3,185257,1570149,1384892
SMI030-K04-B01-M03,0,2,Pf3D7_11_v3,110641,2003008,1892367
SMI030-K04-B01-M03,0,2,Pf3D7_12_v3,61435,2155095,2093660
SMI030-K04-B01-M03,0,2,Pf3D7_13_v3,77901,106161,28260
SMI030-K04-B01-M03,0,2,Pf3D7_13_v3,367468,934650,567182
SMI030-K04-B01-M03,0,2,Pf3D7_13_v3,956051,2788579,1832528
SMI030-K04-B01-M03,0,2,Pf3D7_14_v3,35796,918720,882924
SMI030-K04-B01-M03,0,2,Pf3D7_14_v3,2006084,2999217,993133
SMI030-K04-B01-M03,0,3,Pf3D7_01_v3,95518,238688,143170
SMI030-K04-B01-M03,0,3,Pf3D7_01_v3,527341,567657,40316
SMI030-K04-B01-M03,0,3,Pf3D7_02_v3,109248,414955,305707
SMI030-K04-B01-M03,0,3,Pf3D7_02_v3,468251,862030,393779
SMI030-K04-B01-M03,0,3,Pf3D7_03_v3,71040,221547,150507
SMI030-K04-B01-M03,0,3,Pf3D7_03_v3,878750,1002946,124196
SMI030-K04-B01-M03,0,3,Pf3D7_04_v3,91817,989851,898034
SMI030-K04-B01-M03,0,3,Pf3D7_04_v3,991236,1143965,152729
SMI030-K04-B01-M03,0,3,Pf3D7_05_v3,39872,132885,93013
SMI030-K04-B01-M03,0,3,Pf3D7_05_v3,216203,1321074,1104871
SMI030-K04-B01-M03,0,3,Pf3D7_06_v3,74373,1111651,1037278
SMI030-K04-B01-M03,0,3,Pf3D7_07_v3,298978,460942,161964
SMI030-K04-B01-M03,0,3,Pf3D7_07_v3,619957,1380526,760569
SMI030-K04-B01-M03,0,3,Pf3D7_08_v3,75691,164893,89202
SMI030-K04-B01-M03,0,3,Pf3D7_08_v3,426411,677481,251070
SMI030-K04-B01-M03,0,3,Pf3D7_08_v3,1109232,1364499,255267
SMI030-K04-B01-M03,0,3,Pf3D7_09_v3,82153,1472334,1390181
SMI030-K04-B01-M03,0,3,Pf3D7_10_v3,70764,1570149,1499385
SMI030-K04-B01-M03,0,3,Pf3D7_11_v3,110641,573281,462640
SMI030-K04-B01-M03,0,3,Pf3D7_11_v3,1294584,2003008,708424
SMI030-K04-B01-M03,0,3,Pf3D7_12_v3,61435,459459,398024
SMI030-K04-B01-M03,0,3,Pf3D7_12_v3,532133,1212111,679978
SMI030-K04-B01-M03,0,3,Pf3D7_12_v3,1397156,2155095,757939
SMI030-K04-B01-M03,0,3,Pf3D7_13_v3,77901,934650,856749
SMI030-K04-B01-M03,0,3,Pf3D7_13_v3,956051,2788579,1832528
SMI030-K04-B01-M03,0,3,Pf3D7_14_v3,35796,918720,882924
SMI030-K04-B01-M03,0,3,Pf3D7_14_v3,1034851,3255607,2220756
SMI030-K04-B01-M03,1,2,Pf3D7_01_v3,95518,527341,431823
SMI030-K04-B01-M03,1,2,Pf3D7_02_v3,468251,862030,393779
SMI030-K04-B01-M03,1,2,Pf3D7_03_v3,71040,221547,150507
SMI030-K04-B01-M03,1,2,Pf3D7_03_v3,758506,1002946,244440
SMI030-K04-B01-M03,1,2,Pf3D7_04_v3,91817,989851,898034
SMI030-K04-B01-M03,1,2,Pf3D7_04_v3,999012,1143965,144953
SMI030-K04-B01-M03,1,2,Pf3D7_05_v3,39872,132885,93013
SMI030-K04-B01-M03,1,2,Pf3D7_05_v3,288857,1321074,1032217
SMI030-K04-B01-M03,1,2,Pf3D7_06_v3,74373,1111651,1037278
SMI030-K04-B01-M03,1,2,Pf3D7_07_v3,298978,460942,161964
SMI030-K04-B01-M03,1,2,Pf3D7_07_v3,466102,495789,29687
SMI030-K04-B01-M03,1,2,Pf3D7_07_v3,619957,1380526,760569
SMI030-K04-B01-M03,1,2,Pf3D7_08_v3,75691,362183,286492
SMI030-K04-B01-M03,1,2,Pf3D7_08_v3,426411,677481,251070
SMI030-K04-B01-M03,1,2,Pf3D7_08_v3,1109232,1364499,255267
SMI030-K04-B01-M03,1,2,Pf3D7_09_v3,82153,1436710,1354557
SMI030-K04-B01-M03,1,2,Pf3D7_10_v3,185257,1570149,1384892
SMI030-K04-B01-M03,1,2,Pf3D7_11_v3,110641,287983,177342
SMI030-K04-B01-M03,1,2,Pf3D7_11_v3,354035,528101,174066
SMI030-K04-B01-M03,1,2,Pf3D7_11_v3,1294584,2003008,708424
SMI030-K04-B01-M03,1,2,Pf3D7_12_v3,61435,1212111,1150676
SMI030-K04-B01-M03,1,2,Pf3D7_12_v3,1397156,2155095,757939
SMI030-K04-B01-M03,1,2,Pf3D7_13_v3,77901,2788579,2710678
SMI030-K04-B01-M03,1,2,Pf3D7_14_v3,35796,1393032,1357236
SMI030-K04-B01-M03,1,2,Pf3D7_14_v3,2006084,2999217,993133
SMI030-K04-B01-M03,1,3,Pf3D7_01_v3,238688,527341,288653
SMI030-K04-B01-M03,1,3,Pf3D7_02_v3,468251,805840,337589
SMI030-K04-B01-M03,1,3,Pf3D7_03_v3,221547,1002946,781399
SMI030-K04-B01-M03,1,3,Pf3D7_04_v3,91817,1143965,1052148
SMI030-K04-B01-M03,1,3,Pf3D7_05_v3,39872,216203,176331
SMI030-K04-B01-M03,1,3,Pf3D7_05_v3,288857,1321074,1032217
SMI030-K04-B01-M03,1,3,Pf3D7_06_v3,74373,1111651,1037278
SMI030-K04-B01-M03,1,3,Pf3D7_07_v3,298978,460942,161964
SMI030-K04-B01-M03,1,3,Pf3D7_07_v3,466102,1380526,914424
SMI030-K04-B01-M03,1,3,Pf3D7_08_v3,75691,426411,350720
SMI030-K04-B01-M03,1,3,Pf3D7_08_v3,677481,1109232,431751
SMI030-K04-B01-M03,1,3,Pf3D7_08_v3,1113495,1364499,251004
SMI030-K04-B01-M03,1,3,Pf3D7_09_v3,82153,1472334,1390181
SMI030-K04-B01-M03,1,3,Pf3D7_10_v3,70764,1570149,1499385
SMI030-K04-B01-M03,1,3,Pf3D7_11_v3,110641,287983,177342
SMI030-K04-B01-M03,1,3,Pf3D7_11_v3,354035,528101,174066
SMI030-K04-B01-M03,1,3,Pf3D7_11_v3,573281,2003008,1429727
SMI030-K04-B01-M03,1,3,Pf3D7_12_v3,61435,459459,398024
SMI030-K04-B01-M03,1,3,Pf3D7_12_v3,532133,2155095,1622962
SMI030-K04-B01-M03,1,3,Pf3D7_13_v3,77901,106161,28260
SMI030-K04-B01-M03,1,3,Pf3D7_13_v3,367468,2788579,2421111
SMI030-K04-B01-M03,1,3,Pf3D7_14_v3,35796,1034851,999055
SMI030-K04-B01-M03,1,3,Pf3D7_14_v3,1393032,3255607,1862575
SMI030-K04-B01-M03,2,3,Pf3D7_01_v3,238688,567657,328969
SMI030-K04-B01-M03,2,3,Pf3D7_02_v3,109248,805840,696592
SMI030-K04-B01-M03,2,3,Pf3D7_03_v3,758506,1002946,244440
SMI030-K04-B01-M03,2,3,Pf3D7_04_v3,91817,989851,898034
SMI030-K04-B01-M03,2,3,Pf3D7_04_v3,999012,1143965,144953
SMI030-K04-B01-M03,2,3,Pf3D7_05_v3,39872,132885,93013
SMI030-K04-B01-M03,2,3,Pf3D7_05_v3,216203,1321074,1104871
SMI030-K04-B01-M03,2,3,Pf3D7_06_v3,74373,1294070,1219697
SMI030-K04-B01-M03,2,3,Pf3D7_07_v3,77194,495789,418595
SMI030-K04-B01-M03,2,3,Pf3D7_07_v3,619957,1380526,760569
SMI030-K04-B01-M03,2,3,Pf3D7_08_v3,75691,362183,286492
SMI030-K04-B01-M03,2,3,Pf3D7_08_v3,1113495,1364499,251004
SMI030-K04-B01-M03,2,3,Pf3D7_09_v3,82153,1436710,1354557
SMI030-K04-B01-M03,2,3,Pf3D7_10_v3,185257,1570149,1384892
SMI030-K04-B01-M03,2,3,Pf3D7_11_v3,110641,573281,462640
SMI030-K04-B01-M03,2,3,Pf3D7_11_v3,1294584,2003008,708424
SMI030-K04-B01-M03,2,3,Pf3D7_12_v3,61435,459459,398024
SMI030-K04-B01-M03,2,3,Pf3D7_12_v3,532133,1212111,679978
SMI030-K04-B01-M03,2,3,Pf3D7_12_v3,1397156,2155095,757939
SMI030-K04-B01-M03,2,3,Pf3D7_13_v3,77901,106161,28260
SMI030-K04-B01-M03,2,3,Pf3D7_13_v3,367468,2788579,2421111
SMI030-K04-B01-M03,2,3,Pf3D7_14_v3,35796,1034851,999055
SMI030-K04-B01-M03,2,3,Pf3D7_14_v3,2006084,2999217,993133
SMI031-K04-B03-M01,0,1,Pf3D7_01_v3,98866,180068,81202
SMI031-K04-B03-M01,0,1,Pf3D7_03_v3,364059,1002946,638887
SMI031-K04-B03-M01,0,1,Pf3D7_04_v3,91817,166432,74615
SMI031-K04-B03-M01,0,1,Pf3D7_04_v3,255939,485886,229947
SMI031-K04-B03-M01,0,1,Pf3D7_04_v3,999012,1143965,144953
SMI031-K04-B03-M01,0,1,Pf3D7_05_v3,39872,92082,52210
SMI031-K04-B03-M01,0,1,Pf3D7_05_v3,216203,658627,442424
SMI031-K04-B03-M01,0,1,Pf3D7_05_v3,1281883,1321074,39191
SMI031-K04-B03-M01,0,1,Pf3D7_06_v3,74373,624118,549745
SMI031-K04-B03-M01,0,1,Pf3D7_06_v3,682542,1111651,429109
SMI031-K04-B03-M01,0,1,Pf3D7_09_v3,556935,1085080,528145
SMI031-K04-B03-M01,0,1,Pf3D7_09_v3,1206357,1206669,312
SMI031-K04-B03-M01,0,1,Pf3D7_10_v3,1254230,1393697,139467
SMI031-K04-B03-M01,0,1,Pf3D7_11_v3,454669,1989087,1534418
SMI031-K04-B03-M01,0,1,Pf3D7_13_v3,390249,2575636,2185387
SMI031-K04-B03-M01,0,1,Pf3D7_14_v3,3043747,3255607,211860
SMI032-K04-B02-M02,0,1,Pf3D7_01_v3,95518,528425,432907
SMI032-K04-B02-M02,0,1,Pf3D7_01_v3,555388,567657,12269
SMI032-K04-B02-M02,0,1,Pf3D7_02_v3,109248,309386,200138
SMI032-K04-B02-M02,0,1,Pf3D7_02_v3,437954,805840,367886
SMI032-K04-B02-M02,0,1,Pf3D7_03_v3,510782,688049,177267
SMI032-K04-B02-M02,0,1,Pf3D7_04_v3,144427,255939,111512
SMI032-K04-B02-M02,0,1,Pf3D7_04_v3,415353,1143965,728612
SMI032-K04-B02-M02,0,1,Pf3D7_05_v3,39872,383150,343278
SMI032-K04-B02-M02,0,1,Pf3D7_05_v3,450949,1204155,753206
SMI032-K04-B02-M02,0,1,Pf3D7_06_v3,635935,1111651,475716
SMI032-K04-B02-M02,0,1,Pf3D7_06_v3,1287479,1294070,6591
SMI032-K04-B02-M02,0,1,Pf3D7_07_v3,77194,204876,127682
SMI032-K04-B02-M02,0,1,Pf3D7_07_v3,472858,1263041,790183
SMI032-K04-B02-M02,0,1,Pf3D7_08_v3,165324,339406,174082
SMI032-K04-B02-M02,0,1,Pf3D7_08_v3,509018,707340,198322
SMI032-K04-B02-M02,0,1,Pf3D7_08_v3,942217,1084240,142023
SMI032-K04-B02-M02,0,1,Pf3D7_08_v3,1143764,1364499,220735
SMI032-K04-B02-M02,0,1,Pf3D7_09_v3,82153,416031,333878
SMI032-K04-B02-M02,0,1,Pf3D7_09_v3,1014530,1472334,457804
SMI032-K04-B02-M02,0,1,Pf3D7_10_v3,70764,188881,118117
SMI032-K04-B02-M02,0,1,Pf3D7_11_v3,427218,1188635,761417
SMI032-K04-B02-M02,0,1,Pf3D7_11_v3,1275605,1294584,18979
SMI032-K04-B02-M02,0,1,Pf3D7_11_v3,1943989,2003008,59019
SMI032-K04-B02-M02,0,1,Pf3D7_12_v3,61435,1670700,1609265
SMI032-K04-B02-M02,0,1,Pf3D7_12_v3,2142883,2155095,12212
SMI032-K04-B02-M02,0,1,Pf3D7_13_v3,77901,305484,227583
SMI032-K04-B02-M02,0,1,Pf3D7_13_v3,1891015,2161975,270960
SMI032-K04-B02-M02,0,1,Pf3D7_14_v3,918720,1028118,109398
SMI032-K04-B02-M02,0,1,Pf3D7_14_v3,1103652,3255607,2151955
SMI032-K04-B02-M02,0,2,Pf3D7_01_v3,536113,567657,31544
SMI032-K04-B02-M02,0,2,Pf3D7_02_v3,109248,468251,359003
SMI032-K04-B02-M02,0,2,Pf3D7_02_v3,805840,862030,56190
SMI032-K04-B02-M02,0,2,Pf3D7_03_v3,71040,510782,439742
SMI032-K04-B02-M02,0,2,Pf3D7_04_v3,144427,255939,111512
SMI032-K04-B02-M02,0,2,Pf3D7_04_v3,415353,996798,581445
SMI032-K04-B02-M02,0,2,Pf3D7_04_v3,999012,1143965,144953
SMI032-K04-B02-M02,0,2,Pf3D7_05_v3,39872,450949,411077
SMI032-K04-B02-M02,0,2,Pf3D7_05_v3,505628,1321074,815446
SMI032-K04-B02-M02,0,2,Pf3D7_06_v3,74373,154779,80406
SMI032-K04-B02-M02,0,2,Pf3D7_06_v3,796597,1294070,497473
SMI032-K04-B02-M02,0,2,Pf3D7_07_v3,77194,472858,395664
SMI032-K04-B02-M02,0,2,Pf3D7_07_v3,619957,787582,167625
SMI032-K04-B02-M02,0,2,Pf3D7_08_v3,1143764,1364499,220735
SMI032-K04-B02-M02,0,2,Pf3D7_09_v3,82153,416031,333878
SMI032-K04-B02-M02,0,2,Pf3D7_10_v3,188881,1254230,1065349
SMI032-K04-B02-M02,0,2,Pf3D7_10_v3,1386703,1570149,183446
SMI032-K04-B02-M02,0,2,Pf3D7_11_v3,110641,1275605,1164964
SMI032-K04-B02-M02,0,2,Pf3D7_12_v3,382400,1054417,672017
SMI032-K04-B02-M02,0,2,Pf3D7_12_v3,1670700,2155095,484395
SMI032-K04-B02-M02,0,2,Pf3D7_13_v3,77901,1682933,1605032
SMI032-K04-B02-M02,0,2,Pf3D7_13_v3,1891015,2161975,270960
SMI032-K04-B02-M02,0,2,Pf3D7_14_v3,40153,910628,870475
SMI032-K04-B02-M02,0,2,Pf3D7_14_v3,1028118,3189467,2161349
SMI032-K04-B02-M02,1,2,Pf3D7_01_v3,528425,536113,7688
SMI032-K04-B02-M02,1,2,Pf3D7_01_v3,555388,567657,12269
SMI032-K04-B02-M02,1,2,Pf3D7_02_v3,109248,309386,200138
SMI032-K04-B02-M02,1,2,Pf3D7_02_v3,437954,468251,30297
SMI032-K04-B02-M02,1,2,Pf3D7_03_v3,688049,1002946,314897
SMI032-K04-B02-M02,1,2,Pf3D7_04_v3,91817,996798,904981
SMI032-K04-B02-M02,1,2,Pf3D7_04_v3,999012,1143965,144953
SMI032-K04-B02-M02,1,2,Pf3D7_05_v3,39872,383150,343278
SMI032-K04-B02-M02,1,2,Pf3D7_05_v3,505628,1204155,698527
SMI032-K04-B02-M02,1,2,Pf3D7_06_v3,154779,635935,481156
SMI032-K04-B02-M02,1,2,Pf3D7_06_v3,796597,1111651,315054
SMI032-K04-B02-M02,1,2,Pf3D7_06_v3,1287479,1294070,6591
SMI032-K04-B02-M02,1,2,Pf3D7_07_v3,77194,204876,127682
SMI032-K04-B02-M02,1,2,Pf3D7_07_v3,619957,787582,167625
SMI032-K04-B02-M02,1,2,Pf3D7_07_v3,1263041,1380526,117485
SMI032-K04-B02-M02,1,2,Pf3D7_08_v3,75691,165324,89633
SMI032-K04-B02-M02,1,2,Pf3D7_08_v3,339406,509018,169612
SMI032-K04-B02-M02,1,2,Pf3D7_08_v3,707340,942217,234877
SMI032-K04-B02-M02,1,2,Pf3D7_08_v3,1084240,1364499,280259
SMI032-K04-B02-M02,1,2,Pf3D7_09_v3,82153,1014530,932377
SMI032-K04-B02-M02,1,2,Pf3D7_10_v3,1254230,1386703,132473
SMI032-K04-B02-M02,1,2,Pf3D7_11_v3,427218,1188635,761417
SMI032-K04-B02-M02,1,2,Pf3D7_11_v3,1294584,1943989,649405
SMI032-K04-B02-M02,1,2,Pf3D7_12_v3,382400,1054417,672017
SMI032-K04-B02-M02,1,2,Pf3D7_12_v3,2142883,2155095,12212
SMI032-K04-B02-M02,1,2,Pf3D7_13_v3,77901,305484,227583
SMI032-K04-B02-M02,1,2,Pf3D7_13_v3,1682933,2788579,1105646
SMI032-K04-B02-M02,1,2,Pf3D7_14_v3,35796,40153,4357
SMI032-K04-B02-M02,1,2,Pf3D7_14_v3,910628,918720,8092
SMI032-K04-B02-M02,1,2,Pf3D7_14_v3,1103652,3189467,2085815
SMI033-K04-B02-M02,0,1,Pf3D7_01_v3,530429,567657,37228
SMI033-K04-B02-M02,0,1,Pf3D7_02_v3,109248,805840,696592
SMI033-K04-B02-M02,0,1,Pf3D7_03_v3,152653,1002946,850293
SMI033-K04-B02-M02,0,1,Pf3D7_04_v3,91817,221401,129584
SMI033-K04-B02-M02,0,1,Pf3D7_04_v3,255939,530075,274136
SMI033-K04-B02-M02,0,1,Pf3D7_05_v3,1038517,1273649,235132
SMI033-K04-B02-M02,0,1,Pf3D7_07_v3,488471,619957,131486
SMI033-K04-B02-M02,0,1,Pf3D7_08_v3,501390,706619,205229
SMI033-K04-B02-M02,0,1,Pf3D7_08_v3,1152268,1364499,212231
SMI033-K04-B02-M02,0,1,Pf3D7_09_v3,82153,1472334,1390181
SMI033-K04-B02-M02,0,1,Pf3D7_10_v3,70764,92671,21907
SMI033-K04-B02-M02,0,1,Pf3D7_10_v3,1394281,1570149,175868
SMI033-K04-B02-M02,0,1,Pf3D7_11_v3,110641,1699474,1588833
SMI033-K04-B02-M02,0,1,Pf3D7_13_v3,390249,1565364,1175115
SMI033-K04-B02-M02,0,1,Pf3D7_14_v3,918720,2699864,1781144
SMI033-K04-B02-M02,0,1,Pf3D7_14_v3,3030631,3255607,224976
SMI033-K04-B02-M02,0,2,Pf3D7_01_v3,95518,283144,187626
SMI033-K04-B02-M02,0,2,Pf3D7_02_v3,805840,862030,56190
SMI033-K04-B02-M02,0,2,Pf3D7_03_v3,71040,152653,81613
SMI033-K04-B02-M02,0,2,Pf3D7_04_v3,221401,255939,34538
SMI033-K04-B02-M02,0,2,Pf3D7_04_v3,999012,1037433,38421
SMI033-K04-B02-M02,0,2,Pf3D7_05_v3,561510,1038517,477007
SMI033-K04-B02-M02,0,2,Pf3D7_06_v3,1111651,1294070,182419
SMI033-K04-B02-M02,0,2,Pf3D7_07_v3,77194,126688,49494
SMI033-K04-B02-M02,0,2,Pf3D7_07_v3,619957,1380526,760569
SMI033-K04-B02-M02,0,2,Pf3D7_08_v3,75691,501390,425699
SMI033-K04-B02-M02,0,2,Pf3D7_08_v3,706619,1152268,445649
SMI033-K04-B02-M02,0,2,Pf3D7_10_v3,92671,1394281,1301610
SMI033-K04-B02-M02,0,2,Pf3D7_11_v3,1699474,1943989,244515
SMI033-K04-B02-M02,0,2,Pf3D7_12_v3,198985,382400,183415
SMI033-K04-B02-M02,0,2,Pf3D7_12_v3,418827,1670700,1251873
SMI033-K04-B02-M02,0,2,Pf3D7_14_v3,528659,918720,390061
SMI033-K04-B02-M02,0,2,Pf3D7_14_v3,2699864,3030631,330767
SMI033-K04-B02-M02,1,2,Pf3D7_01_v3,283144,530429,247285
SMI033-K04-B02-M02,1,2,Pf3D7_04_v3,530075,999012,468937
SMI033-K04-B02-M02,1,2,Pf3D7_04_v3,1037433,1143965,106532
SMI033-K04-B02-M02,1,2,Pf3D7_05_v3,39872,561510,521638
SMI033-K04-B02-M02,1,2,Pf3D7_05_v3,1273649,1321074,47425
SMI033-K04-B02-M02,1,2,Pf3D7_06_v3,74373,1111651,1037278
SMI033-K04-B02-M02,1,2,Pf3D7_07_v3,126688,488471,361783
SMI033-K04-B02-M02,1,2,Pf3D7_11_v3,1943989,2003008,59019
SMI033-K04-B02-M02,1,2,Pf3D7_12_v3,61435,198985,137550
SMI033-K04-B02-M02,1,2,Pf3D7_12_v3,382400,418827,36427
SMI033-K04-B02-M02,1,2,Pf3D7_12_v3,1670700,2155095,484395
SMI033-K04-B02-M02,1,2,Pf3D7_13_v3,77901,390249,312348
SMI033-K04-B02-M02,1,2,Pf3D7_13_v3,1565364,2788579,1223215
SMI033-K04-B02-M02,1,2,Pf3D7_14_v3,35796,528659,492863
SMI034-K04-B02-M02,0,1,Pf3D7_01_v3,130339,567657,437318
SMI034-K04-B02-M02,0,1,Pf3D7_02_v3,109248,468251,359003
SMI034-K04-B02-M02,0,1,Pf3D7_02_v3,614624,805840,191216
SMI034-K04-B02-M02,0,1,Pf3D7_03_v3,622763,1002946,380183
SMI034-K04-B02-M02,0,1,Pf3D7_04_v3,91817,881382,789565
SMI034-K04-B02-M02,0,1,Pf3D7_04_v3,897099,907571,10472
SMI034-K04-B02-M02,0,1,Pf3D7_04_v3,999012,1036984,37972
SMI034-K04-B02-M02,0,1,Pf3D7_05_v3,39872,92675,52803
SMI034-K04-B02-M02,0,1,Pf3D7_05_v3,130006,269459,139453
SMI034-K04-B02-M02,0,1,Pf3D7_05_v3,610440,1038517,428077
SMI034-K04-B02-M02,0,1,Pf3D7_05_v3,1204155,1219781,15626
SMI034-K04-B02-M02,0,1,Pf3D7_06_v3,229021,581035,352014
SMI034-K04-B02-M02,0,1,Pf3D7_06_v3,1111651,1294070,182419
SMI034-K04-B02-M02,0,1,Pf3D7_07_v3,77194,619957,542763
SMI034-K04-B02-M02,0,1,Pf3D7_07_v3,900965,1380526,479561
SMI034-K04-B02-M02,0,1,Pf3D7_08_v3,75691,1113495,1037804
SMI034-K04-B02-M02,0,1,Pf3D7_09_v3,544207,1472334,928127
SMI034-K04-B02-M02,0,1,Pf3D7_10_v3,70764,1254230,1183466
SMI034-K04-B02-M02,0,1,Pf3D7_10_v3,1550250,1570149,19899
SMI034-K04-B02-M02,0,1,Pf3D7_11_v3,110641,408566,297925
SMI034-K04-B02-M02,0,1,Pf3D7_11_v3,582304,778298,195994
SMI034-K04-B02-M02,0,1,Pf3D7_11_v3,1294753,2003008,708255
SMI034-K04-B02-M02,0,1,Pf3D7_12_v3,61435,122749,61314
SMI034-K04-B02-M02,0,1,Pf3D7_12_v3,1243586,1380967,137381
SMI034-K04-B02-M02,0,1,Pf3D7_12_v3,1670700,2155095,484395
SMI034-K04-B02-M02,0,1,Pf3D7_13_v3,77901,585306,507405
SMI034-K04-B02-M02,0,1,Pf3D7_14_v3,512987,1484146,971159
SMI034-K04-B02-M02,0,1,Pf3D7_14_v3,2231863,3030631,798768
SMI034-K04-B02-M02,0,1,Pf3D7_14_v3,3122601,3255607,133006
SMI034-K04-B02-M02,0,1,Pf3D7_02_v3,145709,468251,322542
SMI034-K04-B02-M02,0,1,Pf3D7_02_v3,554110,862030,307920
SMI034-K04-B02-M02,0,1,Pf3D7_03_v3,71040,563024,491984
SMI034-K04-B02-M02,0,1,Pf3D7_03_v3,818649,1002946,184297
SMI034-K04-B02-M02,0,1,Pf3D7_04_v3,91817,544797,452980
SMI034-K04-B02-M02,0,1,Pf3D7_04_v3,748262,766795,18533
SMI034-K04-B02-M02,0,1,Pf3D7_04_v3,880848,1143965,263117
SMI034-K04-B02-M02,0,1,Pf3D7_05_v3,39872,616768,576896
SMI034-K04-B02-M02,0,1,Pf3D7_05_v3,675808,1038517,362709
SMI034-K04-B02-M02,0,1,Pf3D7_05_v3,1185053,1321074,136021
SMI034-K04-B02-M02,0,1,Pf3D7_06_v3,74373,796597,722224
SMI034-K04-B02-M02,0,1,Pf3D7_06_v3,1111651,1294070,182419
SMI034-K04-B02-M02,0,1,Pf3D7_07_v3,77194,77312,118
SMI034-K04-B02-M02,0,1,Pf3D7_07_v3,480458,1380526,900068
SMI034-K04-B02-M02,0,1,Pf3D7_08_v3,75691,1364499,1288808
SMI034-K04-B02-M02,0,1,Pf3D7_09_v3,82153,850295,768142
SMI034-K04-B02-M02,0,1,Pf3D7_09_v3,1469377,1472334,2957
SMI034-K04-B02-M02,0,1,Pf3D7_10_v3,431272,1014307,583035
SMI034-K04-B02-M02,0,1,Pf3D7_10_v3,1254230,1570149,315919
SMI034-K04-B02-M02,0,1,Pf3D7_11_v3,110641,2003008,1892367
SMI034-K04-B02-M02,0,1,Pf3D7_12_v3,61435,382400,320965
SMI034-K04-B02-M02,0,1,Pf3D7_12_v3,426253,2155095,1728842
SMI034-K04-B02-M02,0,1,Pf3D7_13_v3,77901,373474,295573
SMI034-K04-B02-M02,0,1,Pf3D7_13_v3,1891015,2410243,519228
SMI034-K04-B02-M02,0,1,Pf3D7_13_v3,2575636,2788579,212943
SMI034-K04-B02-M02,0,1,Pf3D7_14_v3,35796,2574532,2538736
SMI034-K04-B02-M02,0,1,Pf3D7_14_v3,2867962,2993555,125593
SMI036-K04-B03-M02,0,1,Pf3D7_01_v3,95518,536113,440595
SMI036-K04-B03-M02,0,1,Pf3D7_02_v3,257404,290666,33262
SMI036-K04-B03-M02,0,1,Pf3D7_02_v3,468251,862030,393779
SMI036-K04-B03-M02,0,1,Pf3D7_03_v3,71040,1002946,931906
SMI036-K04-B03-M02,0,1,Pf3D7_04_v3,91817,989342,897525
SMI036-K04-B03-M02,0,1,Pf3D7_04_v3,999012,1143965,144953
SMI036-K04-B03-M02,0,1,Pf3D7_05_v3,39872,1321074,1281202
SMI036-K04-B03-M02,0,1,Pf3D7_06_v3,74373,159992,85619
SMI036-K04-B03-M02,0,1,Pf3D7_06_v3,1111651,1294070,182419
SMI036-K04-B03-M02,0,1,Pf3D7_07_v3,77194,158694,81500
SMI036-K04-B03-M02,0,1,Pf3D7_07_v3,477049,1380526,903477
SMI036-K04-B03-M02,0,1,Pf3D7_08_v3,75691,1364499,1288808
SMI036-K04-B03-M02,0,1,Pf3D7_09_v3,82153,602885,520732
SMI036-K04-B03-M02,0,1,Pf3D7_09_v3,701798,929701,227903
SMI036-K04-B03-M02,0,1,Pf3D7_10_v3,1254230,1570149,315919
SMI036-K04-B03-M02,0,1,Pf3D7_11_v3,110641,1294584,1183943
SMI036-K04-B03-M02,0,1,Pf3D7_12_v3,1670700,2155095,484395
SMI036-K04-B03-M02,0,1,Pf3D7_13_v3,77901,2788579,2710678
SMI036-K04-B03-M02,0,1,Pf3D7_14_v3,35796,3255607,3219811
SMI037-K04-B01-M03,0,1,Pf3D7_01_v3,531735,567657,35922
SMI037-K04-B01-M03,0,1,Pf3D7_02_v3,109248,109905,657
SMI037-K04-B01-M03,0,1,Pf3D7_02_v3,297229,805840,508611
SMI037-K04-B01-M03,0,1,Pf3D7_02_v3,845624,857502,11878
SMI037-K04-B01-M03,0,1,Pf3D7_03_v3,71493,507451,435958
SMI037-K04-B01-M03,0,1,Pf3D7_03_v3,878750,1002946,124196
SMI037-K04-B01-M03,0,1,Pf3D7_04_v3,91817,115195,23378
SMI037-K04-B01-M03,0,1,Pf3D7_04_v3,165307,860538,695231
SMI037-K04-B01-M03,0,1,Pf3D7_04_v3,883288,934917,51629
SMI037-K04-B01-M03,0,1,Pf3D7_04_v3,999012,1054898,55886
SMI037-K04-B01-M03,0,1,Pf3D7_05_v3,132132,673393,541261
SMI037-K04-B01-M03,0,1,Pf3D7_05_v3,921466,984614,63148
SMI037-K04-B01-M03,0,1,Pf3D7_05_v3,1027900,1321074,293174
SMI037-K04-B01-M03,0,1,Pf3D7_06_v3,74373,159084,84711
SMI037-K04-B01-M03,0,1,Pf3D7_06_v3,240510,1294070,1053560
SMI037-K04-B01-M03,0,1,Pf3D7_07_v3,77194,460942,383748
SMI037-K04-B01-M03,0,1,Pf3D7_07_v3,480458,946630,466172
SMI037-K04-B01-M03,0,1,Pf3D7_08_v3,585841,1364499,778658
SMI037-K04-B01-M03,0,1,Pf3D7_09_v3,82153,1472334,1390181
SMI037-K04-B01-M03,0,1,Pf3D7_10_v3,70764,695825,625061
SMI037-K04-B01-M03,0,1,Pf3D7_10_v3,1074462,1387185,312723
SMI037-K04-B01-M03,0,1,Pf3D7_10_v3,1399613,1570149,170536
SMI037-K04-B01-M03,0,1,Pf3D7_11_v3,110641,1229873,1119232
SMI037-K04-B01-M03,0,1,Pf3D7_11_v3,1294584,2003008,708424
SMI037-K04-B01-M03,0,1,Pf3D7_12_v3,61435,2155095,2093660
SMI037-K04-B01-M03,0,1,Pf3D7_13_v3,77901,106161,28260
SMI037-K04-B01-M03,0,1,Pf3D7_13_v3,204962,2788579,2583617
SMI037-K04-B01-M03,0,1,Pf3D7_14_v3,35796,481785,445989
SMI037-K04-B01-M03,0,1,Pf3D7_14_v3,699548,1037043,337495
SMI037-K04-B01-M03,0,1,Pf3D7_14_v3,1093460,1446691,353231
SMI037-K04-B01-M03,0,1,Pf3D7_14_v3,1912280,3124670,1212390
SMI037-K04-B01-M03,0,2,Pf3D7_01_v3,95518,531735,436217
SMI037-K04-B01-M03,0,2,Pf3D7_02_v3,109905,862030,752125
SMI037-K04-B01-M03,0,2,Pf3D7_03_v3,71040,729186,658146
SMI037-K04-B01-M03,0,2,Pf3D7_03_v3,878750,1002946,124196
SMI037-K04-B01-M03,0,2,Pf3D7_04_v3,91817,115195,23378
SMI037-K04-B01-M03,0,2,Pf3D7_04_v3,165307,860538,695231
SMI037-K04-B01-M03,0,2,Pf3D7_04_v3,883288,934917,51629
SMI037-K04-B01-M03,0,2,Pf3D7_04_v3,997348,1143965,146617
SMI037-K04-B01-M03,0,2,Pf3D7_05_v3,39872,132132,92260
SMI037-K04-B01-M03,0,2,Pf3D7_05_v3,369824,657290,287466
SMI037-K04-B01-M03,0,2,Pf3D7_05_v3,673393,910775,237382
SMI037-K04-B01-M03,0,2,Pf3D7_05_v3,921466,1321074,399608
SMI037-K04-B01-M03,0,2,Pf3D7_06_v3,74373,159084,84711
SMI037-K04-B01-M03,0,2,Pf3D7_06_v3,240510,1111651,871141
SMI037-K04-B01-M03,0,2,Pf3D7_06_v3,1235507,1268688,33181
SMI037-K04-B01-M03,0,2,Pf3D7_06_v3,1282691,1294070,11379
SMI037-K04-B01-M03,0,2,Pf3D7_07_v3,77194,202640,125446
SMI037-K04-B01-M03,0,2,Pf3D7_07_v3,460942,1252760,791818
SMI037-K04-B01-M03,0,2,Pf3D7_08_v3,585841,845787,259946
SMI037-K04-B01-M03,0,2,Pf3D7_08_v3,1116244,1364499,248255
SMI037-K04-B01-M03,0,2,Pf3D7_09_v3,82153,544207,462054
SMI037-K04-B01-M03,0,2,Pf3D7_09_v3,764812,1472334,707522
SMI037-K04-B01-M03,0,2,Pf3D7_10_v3,70764,561234,490470
SMI037-K04-B01-M03,0,2,Pf3D7_10_v3,1254230,1387185,132955
SMI037-K04-B01-M03,0,2,Pf3D7_10_v3,1399613,1570149,170536
SMI037-K04-B01-M03,0,2,Pf3D7_11_v3,110641,2003008,1892367
SMI037-K04-B01-M03,0,2,Pf3D7_12_v3,61435,2155095,2093660
SMI037-K04-B01-M03,0,2,Pf3D7_13_v3,77901,106161,28260
SMI037-K04-B01-M03,0,2,Pf3D7_13_v3,204962,584983,380021
SMI037-K04-B01-M03,0,2,Pf3D7_13_v3,1330092,1333878,3786
SMI037-K04-B01-M03,0,2,Pf3D7_13_v3,1891015,2788579,897564
SMI037-K04-B01-M03,0,2,Pf3D7_14_v3,35796,2727779,2691983
SMI037-K04-B01-M03,0,2,Pf3D7_14_v3,3124670,3255607,130937
SMI037-K04-B01-M03,0,3,Pf3D7_02_v3,297229,805840,508611
SMI037-K04-B01-M03,0,3,Pf3D7_02_v3,845624,857502,11878
SMI037-K04-B01-M03,0,3,Pf3D7_03_v3,71493,507451,435958
SMI037-K04-B01-M03,0,3,Pf3D7_03_v3,729186,1002946,273760
SMI037-K04-B01-M03,0,3,Pf3D7_04_v3,91817,997348,905531
SMI037-K04-B01-M03,0,3,Pf3D7_04_v3,999012,1054898,55886
SMI037-K04-B01-M03,0,3,Pf3D7_05_v3,369824,657290,287466
SMI037-K04-B01-M03,0,3,Pf3D7_05_v3,910775,984614,73839
SMI037-K04-B01-M03,0,3,Pf3D7_05_v3,1027900,1321074,293174
SMI037-K04-B01-M03,0,3,Pf3D7_06_v3,74373,1111651,1037278
SMI037-K04-B01-M03,0,3,Pf3D7_06_v3,1235507,1268688,33181
SMI037-K04-B01-M03,0,3,Pf3D7_06_v3,1282691,1294070,11379
SMI037-K04-B01-M03,0,3,Pf3D7_07_v3,77194,202640,125446
SMI037-K04-B01-M03,0,3,Pf3D7_07_v3,480458,946630,466172
SMI037-K04-B01-M03,0,3,Pf3D7_07_v3,1252760,1380526,127766
SMI037-K04-B01-M03,0,3,Pf3D7_08_v3,75691,845787,770096
SMI037-K04-B01-M03,0,3,Pf3D7_08_v3,1116244,1364499,248255
SMI037-K04-B01-M03,0,3,Pf3D7_09_v3,82153,544207,462054
SMI037-K04-B01-M03,0,3,Pf3D7_09_v3,764812,1472334,707522
SMI037-K04-B01-M03,0,3,Pf3D7_10_v3,70764,561234,490470
SMI037-K04-B01-M03,0,3,Pf3D7_10_v3,695825,1074462,378637
SMI037-K04-B01-M03,0,3,Pf3D7_10_v3,1254230,1570149,315919
SMI037-K04-B01-M03,0,3,Pf3D7_11_v3,110641,1229873,1119232
SMI037-K04-B01-M03,0,3,Pf3D7_11_v3,1294584,2003008,708424
SMI037-K04-B01-M03,0,3,Pf3D7_12_v3,61435,2155095,2093660
SMI037-K04-B01-M03,0,3,Pf3D7_13_v3,77901,584983,507082
SMI037-K04-B01-M03,0,3,Pf3D7_13_v3,1330092,1333878,3786
SMI037-K04-B01-M03,0,3,Pf3D7_13_v3,1891015,2788579,897564
SMI037-K04-B01-M03,0,3,Pf3D7_14_v3,35796,481785,445989
SMI037-K04-B01-M03,0,3,Pf3D7_14_v3,699548,1037043,337495
SMI037-K04-B01-M03,0,3,Pf3D7_14_v3,1093460,1446691,353231
SMI037-K04-B01-M03,0,3,Pf3D7_14_v3,1912280,2727779,815499
SMI037-K04-B01-M03,1,2,Pf3D7_02_v3,297229,805840,508611
SMI037-K04-B01-M03,1,2,Pf3D7_02_v3,845624,857502,11878
SMI037-K04-B01-M03,1,2,Pf3D7_03_v3,71493,507451,435958
SMI037-K04-B01-M03,1,2,Pf3D7_03_v3,729186,1002946,273760
SMI037-K04-B01-M03,1,2,Pf3D7_04_v3,91817,997348,905531
SMI037-K04-B01-M03,1,2,Pf3D7_04_v3,999012,1054898,55886
SMI037-K04-B01-M03,1,2,Pf3D7_05_v3,369824,657290,287466
SMI037-K04-B01-M03,1,2,Pf3D7_05_v3,910775,984614,73839
SMI037-K04-B01-M03,1,2,Pf3D7_05_v3,1027900,1321074,293174
SMI037-K04-B01-M03,1,2,Pf3D7_06_v3,74373,1111651,1037278
SMI037-K04-B01-M03,1,2,Pf3D7_06_v3,1235507,1268688,33181
SMI037-K04-B01-M03,1,2,Pf3D7_06_v3,1282691,1294070,11379
SMI037-K04-B01-M03,1,2,Pf3D7_07_v3,77194,202640,125446
SMI037-K04-B01-M03,1,2,Pf3D7_07_v3,480458,946630,466172
SMI037-K04-B01-M03,1,2,Pf3D7_07_v3,1252760,1380526,127766
SMI037-K04-B01-M03,1,2,Pf3D7_08_v3,75691,845787,770096
SMI037-K04-B01-M03,1,2,Pf3D7_08_v3,1116244,1364499,248255
SMI037-K04-B01-M03,1,2,Pf3D7_09_v3,82153,544207,462054
SMI037-K04-B01-M03,1,2,Pf3D7_09_v3,764812,1472334,707522
SMI037-K04-B01-M03,1,2,Pf3D7_10_v3,70764,561234,490470
SMI037-K04-B01-M03,1,2,Pf3D7_10_v3,695825,1074462,378637
SMI037-K04-B01-M03,1,2,Pf3D7_10_v3,1254230,1570149,315919
SMI037-K04-B01-M03,1,2,Pf3D7_11_v3,110641,1229873,1119232
SMI037-K04-B01-M03,1,2,Pf3D7_11_v3,1294584,2003008,708424
SMI037-K04-B01-M03,1,2,Pf3D7_12_v3,61435,2155095,2093660
SMI037-K04-B01-M03,1,2,Pf3D7_13_v3,77901,584983,507082
SMI037-K04-B01-M03,1,2,Pf3D7_13_v3,1330092,1333878,3786
SMI037-K04-B01-M03,1,2,Pf3D7_13_v3,1891015,2788579,897564
SMI037-K04-B01-M03,1,2,Pf3D7_14_v3,35796,481785,445989
SMI037-K04-B01-M03,1,2,Pf3D7_14_v3,699548,1037043,337495
SMI037-K04-B01-M03,1,2,Pf3D7_14_v3,1093460,1446691,353231
SMI037-K04-B01-M03,1,2,Pf3D7_14_v3,1912280,2727779,815499
SMI037-K04-B01-M03,1,3,Pf3D7_01_v3,95518,531735,436217
SMI037-K04-B01-M03,1,3,Pf3D7_02_v3,109905,862030,752125
SMI037-K04-B01-M03,1,3,Pf3D7_03_v3,71040,729186,658146
SMI037-K04-B01-M03,1,3,Pf3D7_03_v3,878750,1002946,124196
SMI037-K04-B01-M03,1,3,Pf3D7_04_v3,91817,115195,23378
SMI037-K04-B01-M03,1,3,Pf3D7_04_v3,165307,860538,695231
SMI037-K04-B01-M03,1,3,Pf3D7_04_v3,883288,934917,51629
SMI037-K04-B01-M03,1,3,Pf3D7_04_v3,997348,1143965,146617
SMI037-K04-B01-M03,1,3,Pf3D7_05_v3,39872,132132,92260
SMI037-K04-B01-M03,1,3,Pf3D7_05_v3,369824,657290,287466
SMI037-K04-B01-M03,1,3,Pf3D7_05_v3,673393,910775,237382
SMI037-K04-B01-M03,1,3,Pf3D7_05_v3,921466,1321074,399608
SMI037-K04-B01-M03,1,3,Pf3D7_06_v3,74373,159084,84711
SMI037-K04-B01-M03,1,3,Pf3D7_06_v3,240510,1111651,871141
SMI037-K04-B01-M03,1,3,Pf3D7_06_v3,1235507,1268688,33181
SMI037-K04-B01-M03,1,3,Pf3D7_06_v3,1282691,1294070,11379
SMI037-K04-B01-M03,1,3,Pf3D7_07_v3,77194,202640,125446
SMI037-K04-B01-M03,1,3,Pf3D7_07_v3,460942,1252760,791818
SMI037-K04-B01-M03,1,3,Pf3D7_08_v3,585841,845787,259946
SMI037-K04-B01-M03,1,3,Pf3D7_08_v3,1116244,1364499,248255
SMI037-K04-B01-M03,1,3,Pf3D7_09_v3,82153,544207,462054
SMI037-K04-B01-M03,1,3,Pf3D7_09_v3,764812,1472334,707522
SMI037-K04-B01-M03,1,3,Pf3D7_10_v3,70764,561234,490470
SMI037-K04-B01-M03,1,3,Pf3D7_10_v3,1254230,1387185,132955
SMI037-K04-B01-M03,1,3,Pf3D7_10_v3,1399613,1570149,170536
SMI037-K04-B01-M03,1,3,Pf3D7_11_v3,110641,2003008,1892367
SMI037-K04-B01-M03,1,3,Pf3D7_12_v3,61435,2155095,2093660
SMI037-K04-B01-M03,1,3,Pf3D7_13_v3,77901,106161,28260
SMI037-K04-B01-M03,1,3,Pf3D7_13_v3,204962,584983,380021
SMI037-K04-B01-M03,1,3,Pf3D7_13_v3,1330092,1333878,3786
SMI037-K04-B01-M03,1,3,Pf3D7_13_v3,1891015,2788579,897564
SMI037-K04-B01-M03,1,3,Pf3D7_14_v3,35796,2727779,2691983
SMI037-K04-B01-M03,1,3,Pf3D7_14_v3,3124670,3255607,130937
SMI037-K04-B01-M03,2,3,Pf3D7_01_v3,531735,567657,35922
SMI037-K04-B01-M03,2,3,Pf3D7_02_v3,109248,109905,657
SMI037-K04-B01-M03,2,3,Pf3D7_02_v3,297229,805840,508611
SMI037-K04-B01-M03,2,3,Pf3D7_02_v3,845624,857502,11878
SMI037-K04-B01-M03,2,3,Pf3D7_03_v3,71493,507451,435958
SMI037-K04-B01-M03,2,3,Pf3D7_03_v3,878750,1002946,124196
SMI037-K04-B01-M03,2,3,Pf3D7_04_v3,91817,115195,23378
SMI037-K04-B01-M03,2,3,Pf3D7_04_v3,165307,860538,695231
SMI037-K04-B01-M03,2,3,Pf3D7_04_v3,883288,934917,51629
SMI037-K04-B01-M03,2,3,Pf3D7_04_v3,999012,1054898,55886
SMI037-K04-B01-M03,2,3,Pf3D7_05_v3,132132,673393,541261
SMI037-K04-B01-M03,2,3,Pf3D7_05_v3,921466,984614,63148
SMI037-K04-B01-M03,2,3,Pf3D7_05_v3,1027900,1321074,293174
SMI037-K04-B01-M03,2,3,Pf3D7_06_v3,74373,159084,84711
SMI037-K04-B01-M03,2,3,Pf3D7_06_v3,240510,1294070,1053560
SMI037-K04-B01-M03,2,3,Pf3D7_07_v3,77194,460942,383748
SMI037-K04-B01-M03,2,3,Pf3D7_07_v3,480458,946630,466172
SMI037-K04-B01-M03,2,3,Pf3D7_08_v3,585841,1364499,778658
SMI037-K04-B01-M03,2,3,Pf3D7_09_v3,82153,1472334,1390181
SMI037-K04-B01-M03,2,3,Pf3D7_10_v3,70764,695825,625061
SMI037-K04-B01-M03,2,3,Pf3D7_10_v3,1074462,1387185,312723
SMI037-K04-B01-M03,2,3,Pf3D7_10_v3,1399613,1570149,170536
SMI037-K04-B01-M03,2,3,Pf3D7_11_v3,110641,1229873,1119232
SMI037-K04-B01-M03,2,3,Pf3D7_11_v3,1294584,2003008,708424
SMI037-K04-B01-M03,2,3,Pf3D7_12_v3,61435,2155095,2093660
SMI037-K04-B01-M03,2,3,Pf3D7_13_v3,77901,106161,28260
SMI037-K04-B01-M03,2,3,Pf3D7_13_v3,204962,2788579,2583617
SMI037-K04-B01-M03,2,3,Pf3D7_14_v3,35796,481785,445989
SMI037-K04-B01-M03,2,3,Pf3D7_14_v3,699548,1037043,337495
SMI037-K04-B01-M03,2,3,Pf3D7_14_v3,1093460,1446691,353231
SMI037-K04-B01-M03,2,3,Pf3D7_14_v3,1912280,3124670,1212390
